UPC,Item_Number,Quantity_NC,Quantity_AZ,Total,Dealer Price,Sale Price
810042110618,AM568300,37,0,37,29.99,
810042112186,AM768300,35,0,35,22.99,
713780856018,85601-MET,14,8,22,549.99,
713780856025,85602,0,0,0,619.99,
713780856049,85604,2,0,2,549.99,
713780856056,85605,0,0,0,619.99,
713780856070,85607,0,0,0,549.99,
713780856087,85608,0,0,0,619.99,
713780856100,85610,13,49,62,579.99,
713780856124,85612,1,22,23,659.99,
713780856148,85614,10,16,26,579.99,
713780856155,85615,0,0,0,659.99,
713780856179,85617,5,6,11,579.99,
713780856186,85618,0,0,0,659.99,
713780856209,85620,2,2,4,594.99,
713780856223,85622,0,0,0,669.99,
713780856247,85624,5,6,11,594.99,
713780856254,85625,0,6,6,669.99,
713780856353,85635-MET,4,1,5,769.99,
813393018497,ATIGFXH45,0,0,0,454.95,
819644025399,ATIGFXH45M,0,0,0,359.95,
819644028284,ATIGFXS917,5,0,5,279.95,
819644025610,ATIGOMX556MP4,0,0,0,354.95,
813393012600,GERG1911ADOP,13,34,47,279.95,254.95
819644029069,GERG1911ADOPGR,0,0,0,279.95,
813393019425,GERG2210FF,63,0,63,209.95,194.95
813393019562,GERG2210FFG,31,63,94,209.95,194.95
819644026211,GERG2210FFL,12,37,49,,
819644027560,GERG2210FFM,3,12,15,209.95,
819644027256,GERG2210FFS,6,12,18,209.95,
813393019555,GERG2210FFT,8,49,57,209.95,
813393016806,GERG2210GSG9CA,0,0,0,279.95,
813393011504,GERG2210M1911,73,41,114,269.95,
813393013959,GERG2210M1911CA,20,11,31,279.95,
813393018435,GERG2210M1911G,45,28,73,269.95,269.95
813393013911,GERG2210M1911S,81,85,166,269.95,
813393018442,GERG2210M1911T,43,46,89,269.95,254.95
813393019685,GERG2210TFF,69,1,70,209.95,
819644022060,GERG2210TFFL,51,19,70,209.95,
819644027577,GERG2210TFFM,99,75,174,209.95,
819644027065,GERG2210TFFS,5,39,44,209.95,
813393019692,GERG2210TFFT,8,20,28,209.95,
853267007851,GERGMP409X,0,0,0,479.95,
819644026037,ATIG12BDB,0,0,0,329.95,
819644021551,ATIG12NMD18,0,0,0,79.95,
819644024392,ATIG12NMD23C,0,8,8,119.95,
819644021568,ATIG12NMD28,0,0,0,79.95,
819644026839,ATIG12SC26PP,5,0,5,179.95,
819644026792,ATIG12SC26PW,5,0,5,199.95,
819644029243,ATIG15MS410G2,0,0,0,409.95,
819644025290,ATIG15MS556MLP3,0,0,0,399.95,
819644021575,ATIG20NMD18,1,0,1,79.95,
819644024408,ATIG20NMD23C,0,0,0,119.95,
819644021582,ATIG20NMD26,5,0,5,79.95,
819644026846,ATIG20SC26PP,0,0,0,179.95,
819644021599,ATIG410NMD18,0,0,0,79.95,
819644024415,ATIG410NMD23C,0,0,0,119.95,
819644021605,ATIG410NMD26,0,0,0,79.95,
813393016134,ATIGKOF12SVE,29,19,48,479.95,
819644027270,ATIGKOF12SVE30,3,10,13,479.95,
813393016141,ATIGKOF20SVE,18,8,26,479.95,
813393016158,ATIGKOF410SVE,2,6,8,479.95,
892756002687,ATIGLOWMS,0,69,69,41.95,
819644024057,ATIGOMX55615D,0,0,0,429.99,
819644023630,ATIGOMX556FDE15,0,15,15,429.99,
819644025535,ATIGOMX556MP3PF,0,0,0,369.95,
819644021476,GERGGSG1622,0,0,0,299.95,
819644025122,GERGGSG1622G,0,5,5,299.95,
819644025740,GERGGSG1622ML,0,0,0,299.95,
819644027072,GERGGSG1622S,0,0,0,299.95,
819644025139,GERGGSG1622T,0,0,0,299.95,
819644026273,ATIM12BD10,0,0,0,24.95,
819644026679,ATIM12BD5,15,13,28,18.95,
813393019043,ATIM410GA15,0,0,0,23.95,
813393019036,ATIM410GA5,0,0,0,16.95,
813393019579,GERMFF10,70,0,70,19.95,
819644022862,GERMGSG16TP22,0,0,0,29.95,
813393012655,GERMM1911,25,0,25,19.95,
813393019722,GERMMP40925,0,0,0,39.95,
819644027348,ATIARWRENCH2D,0,0,0,23.95,
819644023050,ATINSGLOLF,10,0,10,47.95,
813393011634,ATIDUOSIGHT,0,0,0,34.95,
644406904465,GFT-114,0,1,1,29.49,
644406900283,GL-113,0,0,0,58.49,
644406900344,GL-119,3,0,3,58.49,
644406903055,GL-201,1,2,3,58.49,
644406908746,GL-430,0,0,0,58.49,
644406903246,GL-433,3,2,5,47.49,
644406903253,GL-434,2,2,4,47.49,
644406908807,GL-436,1,2,3,47.49,
644406911395,GL-5433,2,0,2,,
644406911302,GL-816,0,2,2,70.59,
644406911319,GL-817,0,2,2,70.59,
644406911326,GL-818,2,0,2,70.59,
644406911340,GL-819,2,0,2,70.59,
644406911357,GL-820,0,0,0,70.59,
644406911364,GL-821,1,0,1,70.59,
644406911371,GL-822,2,0,2,,
644406911333,GL-823,1,2,3,70.59,
644406905998,SW-145,1,1,2,58.49,
644406906575,SW-443,0,1,1,47.49,
644406906209,GL-446,6,0,6,72.99,
644406910190,SG-448,0,1,1,,
4806015512615,51261,0,96,96,219.99,
4806015512806,51280,0,0,0,244.99,
4806015512837,51283,0,52,52,229.99,
4806015514145,51414-ARM,10,7,17,569.99,
4806015514169,51416,0,26,26,409.99,
4806015514213,51421,0,37,37,404.99,
4806015514299,51429,5,3,8,449.99,
4806015514312,51431,0,86,86,439.99,
4806015514336,51433,0,0,0,599.99,
4806015514343,51434,0,10,10,639.99,
4806015514473,51447,0,0,0,499.99,
4806015514480,51448,0,0,0,549.99,
4806015514534,51453-ARM,0,0,0,459.99,
4806015514701,51470,7,3,10,589.99,
4806015514732,51473,7,2,9,409.99,
4806015514794,51479,1,6,7,549.99,
4806015514848,51484,0,7,7,509.99,
4806015514855,51485,0,13,13,569.99,
4806015514862,51486,0,0,0,539.99,
4806015514879,51487,2,11,13,549.99,
4806015515142,51514,0,99,99,469.99,
4806015515678,51567,0,0,0,679.99,
4806015515777,51577,5,10,15,519.99,
4806015516156,51615,0,22,22,399.99,
4806015516231,51623,2,0,2,539.99,
4806015516323,51632,0,14,14,444.99,
4806015516569,51656,1,19,20,389.99,
4806015517191,51719,7,15,22,539.99,
4806015517382,51738,6,1,7,799.99,
4806015518143,51814,0,0,0,619.99,
4806015518150,51815,0,0,0,409.99,
4806015519126,51912,0,0,0,299.99,
4806015519140,51914,0,0,0,619.99,
4806015519911,51991,11,3,14,549.99,
4806015519942,51994,0,2,2,629.99,
4806015519966,51996,7,6,13,449.99,
4806015520092,52009,0,0,0,619.99,
4806015514176,51417,14,29,43,409.99,
4806015564188,56418,0,0,0,559.99,
4806015564195,56419,0,46,46,559.99,
4806015564621,56462,99,99,198,469.99,
4806015564638,56463,99,99,198,469.99,
4806015564645,56464,99,99,198,469.99,
4806015566250,56625,0,15,15,399.99,
4806015566397,56639,8,9,17,529.99,
4806015566458,56645,0,0,0,829.99,
4806015567899,56789,11,0,11,469.99,
4806015567905,56790,12,3,15,579.99,
4806015568285,56828,0,0,0,579.99,
4806015568292,56829,0,0,0,579.99,
4806015568629,56862,0,48,48,679.99,
4806015568650,56865,0,0,0,624.99,
812285026831,AL22MB,0,0,0,539.99,
812285026299,12RSS24,0,0,0,439.99,
812285025834,601-BC,14,5,19,359.99,
812285026848,AGM5,0,0,0,209.99,
812285026428,PA12H18,0,0,0,209.99,
812285026435,PA12H28,0,10,10,209.99,
812285026121,PA20H26,6,3,9,209.99,
812285026114,PA410H26,3,10,13,209.99,
812285026169,TM22-A-18,99,11,110,249.99,
868042198037,VR80,0,24,24,539.99,
812285025841,VR80-RT,2,7,9,777.99,
812285025612,VR80CA,0,0,0,569.99,
812285025674,VR82,0,0,0,539.99,
812285025544,VRBP100-A,0,0,0,449.99,
812285026374,VRF14,0,0,0,449.99,
812285025605,VRPA40,0,0,0,264.99,
812285021232,10-777,0,0,0,27.99,
812285021164,38747,18,30,48,29.99,
812285021317,380797,0,0,0,22.99,
812285024226,42363,72,34,106,24.99,
812285024240,42379,33,29,62,42.99,
812285023588,46050,9,13,22,20.99,
4806015550891,55089,4,8,12,18.99,
4806015541691,54169-ARM,0,0,0,15.49,
4806015541714,54171,28,10,38,18.99,
4806015541721,54172,0,0,0,15.99,
812285021331,54180B,43,6,49,34.99,
812285021157,54180,5,18,23,30.99,
812285021270,OEMP164015B,0,0,0,29.99,
812285021348,OEMTCM225AFC,15,72,87,19.99,
812285026909,STK10010,8,5,13,11.99,
812285026923,STK10017,8,0,8,11.99,
658175121930,ACMKIRTGBR,0,0,0,89.99,
658175121947,ACMKIRTGCY,2,4,6,89.99,
658175119791,ACMUBHCP1,2,1,3,79.99,
658175115205,ACMUABL1000,2,3,5,269.99,
658175115281,ACMUDCQDM2,5,9,14,89.99,
658175112990,ACMUIR85PR,0,0,0,134.99,
658175115670,DGBNBN4KLRF,3,1,4,789.99,
658175116424,DGWSXS309LTV,3,6,9,529.99,
658175115052,DGWSXS3144KP,11,4,15,609.99,
658175116431,DGWSXS515LTV,4,2,6,599.99,
658175115069,DGWSXS5204KP,4,6,10,699.99,
658175115618,TIBNBX4381L,1,1,2,2259.99,
658175115632,TIBNBX4384L,2,1,3,3349.99,
658175121862,TIMNODN325X,8,10,18,1319.99,1267.19
658175116585,TIMNOLT136X,1,2,3,679.99,
658175116592,TIMNOLT148X,4,1,5,844.99,
658175112563,TIMNOLT319X,0,1,1,1099.99,
658175120391,TIMNOXLT119X,24,8,32,524.99,503.99
658175120407,TIMNOXLT125X,7,2,9,599.99,575.99
658175115076,TIWST4381A,4,4,8,1524.99,
658175115083,TIWST4382A,5,4,9,1859.99,
658175115090,TIWST4384A,7,3,10,2284.99,
658175115106,TIWST4387A,0,1,1,2539.99,
658175115113,TIWST4641A,3,2,5,2539.99,
658175115120,TIWST4642A,1,1,2,2789.99,
658175115144,TIWST4643A,5,2,7,3129.99,
658175115151,TIWST4644A,2,2,4,3549.99,
658175115403,TIWSTLT136X,2,6,8,764.99,
658175115410,TIWSTLT148X,0,2,2,929.99,
658175116455,TIWSTLT319X,2,2,4,1184.99,
658175116462,TIWSTLT325X,4,2,6,1354.99,
658175116479,TIWSTLT335X,0,0,0,1574.99,
658175112556,TIWSTLT350X,6,2,8,1609.99,
602686251112,1911BKO,0,5,5,664.99,
602686422246,1911BKOC6,8,16,24,1089.99,
602686422253,1911BKOC7,17,13,30,1139.99,
602686422352,1911BKOC9,1,0,1,1159.99,
602686421942,1911GCH,12,18,30,1139.99,
602686422499,1911TCAC5N,3,8,11,1429.99,
602686422536,1911TCAC6,19,12,31,944.99,
602686422420,1911TCAC6N,17,3,20,999.99,
602686313056,AOM130,0,0,0,934.99,
602686313087,AOM140,0,0,0,934.99,
602686313094,AOM150,0,0,0,1029.99,
602686311113,MC3010,4,5,9,30.99,
602686311120,MC110AS,1,2,3,30.99,
602686430067,MC3030,0,0,0,,
761862457356,PD10-OC,0,0,0,529.99,
840225709506,SD-122751-US,0,0,0,,
840225708776,SD-123439-2-US,0,0,0,,
,BB-18504,0,0,0,,
816715012012,13273,0,0,0,4131.0,
816715010247,13303-BRT,0,0,0,4026.0,
816715010254,13305,0,0,0,4182.0,
816715011398,13307,0,0,0,4026.0,
816715010025,13316,0,0,0,7700.0,
816715010193,13318,0,0,0,7700.0,
816715012647,14030,0,0,0,7895.0,
816715012616,14031,0,0,0,7895.0,
816715012548,14032,0,0,0,4284.0,
810021510064,18059,0,0,0,11369.0,
810021510071,18062,0,0,0,11369.0,
810021510033,18065,0,0,0,11369.0,
810021510415,18066,0,0,0,11369.0,
810021510439,18067,0,0,0,11369.0,
810021510422,18068,0,0,0,11369.0,
810021510446,18478,0,0,0,5655.0,
810021510453,18479,0,0,0,5655.0,
810021510460,18480,0,0,0,5655.0,
810021510569,18490,0,0,0,5655.0,
810021510576,18491-BRT,1,1,2,5655.0,
810021510590,18493,7,11,18,5655.0,5599.0
810021510606,18494-BRT,3,0,3,5655.0,
810021510620,18496,0,0,0,5655.0,
810021510682,18502,0,0,0,4012.0,
810021510699,18503,0,0,0,4012.0,
810021510705,18504,0,0,0,4012.0,
810021510804,18514-BRT,0,0,0,4012.0,
810021510866,18520,0,0,0,4012.0,
816715012449,12808,12,7,19,171.0,
816715010957,13355,0,0,0,,
816715013453,14077,0,0,0,75.0,
816715010223,13312,0,0,0,5988.0,
810033785177,BA-MLOK-HS,0,0,0,13.99,
810033782534,BAD-ASS-LITE,0,0,0,,
810033785696,BAD-ASS-LITE-BL,8,1,9,48.99,
810033785573,BAD-ASS-LITE-OD,0,4,4,48.99,
810033782565,BAD-ASS-LITE-PR,12,14,26,,
810033785689,BAD-ASS-LITE-RD,0,0,0,48.99,
810033782541,BAD-ASS-PRO,15,10,25,34.99,
810033780486,BAD-EMMR-L-B,0,0,0,18.99,
810033780516,BAD-EMMR-L-FDE,6,0,6,18.99,
810033780509,BAD-EMMR-L-R,20,15,35,18.99,
810033780431,BAD-EMR-B,2,15,17,5.99,
810033780462,BAD-EMR-FDE,2,2,4,5.99,
810033784194,BAD-EMR-OD,26,10,36,5.99,
810033780455,BAD-EMR-R,7,4,11,5.99,
810033780394,BAD-EPS,7,1,8,20.99,
810033780400,BAD-EPS-TI,2,2,4,28.99,
810033780417,BAD-EPS-TI-B,6,1,7,31.99,
810033781261,BAD-LPK-PK3,1,5,6,25.99,
810033781285,BAD-MRK-PK1,0,4,4,12.99,
810033781292,BAD-MRK-PK2,3,4,7,24.99,
810033781834,BAD-RACK-15,0,0,0,64.99,
810033785771,LOM-AP-193,17,0,17,81.99,
810033785788,LOM-AP-ABS,6,6,12,81.99,
082442933849,J212125,0,1,1,500.0,
082442933856,J212126,2,1,3,500.0,
082442188744,J212500,0,0,0,500.0,
082442933825,J320125,2,0,2,500.0,
082442933832,J320126,43,13,56,500.0,
082442188812,J320500,0,0,0,500.0,
082442969411,J80XBLK13,0,0,0,669.0,
082442874500,J90A192FSRF19SK,0,8,8,439.0,
082442736372,J90A1M9A1F19,50,32,82,389.0,
082442736396,J90A1M9F19,0,0,0,389.0,
082442940878,J92CR92070,0,0,0,650.0,
082442940908,J92CR920G70,0,0,0,610.0,
082442940885,J92CR92170,0,0,0,650.0,
082442940915,J92CR921G70,0,0,0,650.0,
082442815503,J92F300M,0,0,0,600.0,
082442940816,J92FR91570,0,0,0,610.0,
082442925998,J92FR915G70,0,0,0,610.0,
082442940793,J92FR92070,0,3,3,650.0,
082442925974,J92FR920G70,2,3,5,610.0,
082442940809,J92FR92170,0,0,0,650.0,
082442925981,J92FR921G70,0,0,0,610.0,
082442937885,J92FSR921,0,0,0,719.0,
082442884967,J92M9A0CA,0,0,0,590.0,
082442816838,J92M9AO,0,0,0,590.0,
082442816371,J92M9AOM,0,0,0,590.0,
082442940854,J92QR91570,0,0,0,610.0,
082442926131,J92QR915G70,0,6,6,610.0,
082442940830,J92QR92070,0,0,0,650.0,
082442926117,J92QR920G70,0,0,0,650.0,
082442940847,J92QR92170,0,0,0,650.0,
082442926124,J92QR921G70,0,0,0,650.0,
082442967363,J92XFMSA21M1,0,0,0,970.0,
082442960357,J92XPCO21,0,0,0,1500.0,
082442111117,J9A4F11,0,0,0,650.0,
082442111087,J9A9F10,0,0,0,575.0,
082442111094,J9A9F11,0,0,0,575.0,
082442954905,JAXF915AI,37,17,54,370.0,
082442954899,JAXF920A1,6,3,9,370.0,
082442954912,JAXF921A1,0,7,7,370.0,
082442943046,JAXN920A1,0,0,0,340.0,
082442943077,JAXN925A1,0,0,0,340.0,
082442943084,JAXN926A1,0,2,2,340.0,
082442943091,JAXN927A1,0,0,0,340.0,
082442940694,JS92M9A4M15,0,0,0,870.0,
082442940687,JS92M9A4GM,0,0,0,870.0,
082442940724,JS92QM9A4GM,0,0,0,870.0,
082442940731,JS92QM9A4M15,0,0,0,870.0,
082442154282,JXC9F21,0,1,1,540.0,
082442864686,JXC9GEL,36,13,49,720.0,720.0
082442819754,JXF5F25,0,0,0,590.0,
082442817286,JXF9F20,0,3,3,540.0,
082442818191,JXF9F21,99,17,116,540.0,
082442974279,SPEC0701A,6,4,10,499.0,
082442969435,SPEC0706A,0,0,0,869.0,
082442884745,J131C11N,0,0,0,1120.0,
082442943138,J131TP18C,0,0,0,1390.0,
082442943114,J131TT18C,0,0,0,1350.0,
082442959849,J32CG11,0,0,0,820.0,
082442960920,J32CS11,0,0,0,900.0,
082442959832,J32CT11,0,0,0,820.0,
082442967479,J32TS18,0,0,0,,
082442967486,J32TS28,0,0,0,,
082442937984,J32TT18,0,0,0,705.0,
082442938066,J32TT28,6,1,7,705.0,
082442938004,J32TU18,17,1,18,770.0,
082442938080,J32TU28,5,4,9,770.0,
082442582252,J40AA26,4,2,6,1430.0,
082442582269,J40AA28,0,0,0,1430.0,
082442709116,J40AA86,0,0,0,1430.0,
082442709109,J40AA88,0,0,0,1430.0,
082442707693,J40AK16,0,1,1,1500.0,
082442707716,J40AK18,2,0,2,1500.0,
082442733319,J40AK18L,2,2,4,1520.0,
082442894102,J40AN16,0,0,0,1550.0,
082442894119,J40AN18,0,0,0,1550.0,
082442923772,J40AN26,0,1,1,1550.0,
082442923789,J40AN28,4,5,9,1550.0,
082442948676,J40AN88,0,0,0,1455.0,
082442707686,J40AW16,1,1,2,1430.0,
082442707709,J40AW18,0,0,0,1430.0,
082442733302,J40AW18L,1,1,2,1450.0,
082442582276,J40AY26,0,0,0,1500.0,
082442582351,J40AY28,2,0,2,1500.0,
082442838038,J40CS10,0,0,0,2490.0,
082442794792,J40CT10,0,0,0,2560.0,
082442837956,J40CT12,0,0,0,2560.0,
082442948171,J42CJ10,0,0,0,1630.0,
082442948164,J42CJ18,0,0,0,1630.0,
082442949789,J42CJ18V,0,0,0,1630.0,
082442948201,J42CK10,0,0,0,1740.0,
082442948195,J42CK18,0,0,0,1740.0,
082442893693,J42XD10,4,3,7,1520.0,
082442893709,J42XD16,4,4,8,1520.0,
082442893716,J42XD18,0,0,0,1520.0,
082442893747,J42XM16,2,4,6,1620.0,
082442893754,J42XM18,0,0,0,1620.0,
082442965024,J42XM28,0,0,0,,
082442893815,J42XN16,4,2,6,1620.0,
082442893822,J42XN18,0,0,0,1620.0,
082442960371,J42XN28,0,1,1,1620.0,
082442967493,J42XS10,0,0,0,,
082442967509,J42XS16,0,0,0,,
082442967516,J42XS18,0,0,0,,
082442960937,J42XS28,0,0,0,1620.0,
082442893846,J42XU16,10,4,14,1620.0,
082442893853,J42XU18,0,0,0,1620.0,
082442960395,J42XU28,0,0,0,1620.0,
082442893877,J42XZ16,6,2,8,1620.0,
082442893884,J42XZ18,0,0,0,1620.0,
082442915036,J686FJ0,0,0,0,1999.0,
082442915043,J686FJ6,0,0,0,1999.0,
082442915050,J686FJ8,0,0,0,1999.0,
082442915067,J686FJ8V,0,0,0,1999.0,
082442915074,J686FK0,0,0,0,1999.0,
082442915081,J686FK6,0,0,0,1999.0,
082442915098,J686FK8,0,0,0,1999.0,
082442915104,J686FK8V,0,0,0,1999.0,
082442915128,J686FM6,0,0,0,1999.0,
082442915135,J686FM8,0,0,0,1999.0,
082442915159,J686FN6,0,0,0,1999.0,
082442915197,J686SJ0,0,0,0,2099.0,
082442915227,J686SJ2,0,0,0,2099.0,
082442942681,JX49221M,0,15,15,700.0,
082442778297,1385979/1,20,20,40,34.99,
082442169217,C89282,99,34,133,29.99,
082442132518,J80400,4,8,12,22.99,
082442012452,JM21,10,5,15,21.99,
082442161679,JM32,12,15,27,21.99,
082442553122,JM4PX917,7,2,9,29.99,
082442553115,JM4PX920,81,69,150,34.99,
082442778242,JM80396HC,0,3,3,35.99,
082442596433,JM904P12,8,8,16,28.99,
082442596426,JM909P17,4,0,4,28.99,
082442133904,JM92F,0,0,0,28.99,
082442778204,JM92HCB,1,7,8,28.99,
082442596464,JM9A115,99,51,150,34.99,
082442873435,JMAPX159,99,48,147,27.99,
082442898650,JMAPX159CENT,7,16,23,27.99,
082442873428,JMAPX179,7,10,17,27.99,
082442873480,JMAPX219,86,21,107,31.99,
082442820606,JMPX4510,17,0,17,32.99,
082442820552,JMPX4S9F,20,17,37,29.99,
043125016198,B14L001C,2,1,3,809.99,
043125016204,B14L002C,0,0,0,809.99,
043125015795,B14L101C,6,3,9,684.99,
043125015801,B14L102C,9,1,10,684.99,
043125016259,B14L501C,1,2,3,734.99,
043125016266,B14L502C,8,0,8,734.99,
043125016211,B14LM001C,0,0,0,809.99,
043125015818,B14LM101C,0,0,0,684.99,
043125015832,B14LM102C,4,1,5,684.99,
043125015160,B14LM111,2,0,2,754.99,
043125016044,B14LM301C,5,0,5,884.99,
043125016051,B14LM301LC,0,0,0,909.99,
043125016068,B14LM358C,1,1,2,929.99,
043125015139,B14LM361,5,0,5,979.99,
043125016075,B14LM361CF,0,0,0,1369.99,
043125015122,B14LM368,3,0,3,1039.99,
043125015399,B14LM5010,0,0,0,814.99,
043125016273,B14LM501C,8,0,8,734.99,
043125016280,B14LM502C,2,1,3,734.99,
043125016303,B14LM508C,0,0,0,734.99,
043125015146,B14LM511,7,0,7,814.99,
043125016341,B14LM511CF,0,0,0,1229.99,
043125015153,B14LM518,0,0,0,814.99,
043125015351,B14LM5610,0,0,0,979.99,
043125015115,B14LM651,2,0,2,979.99,
043125015368,B14LM657,0,0,0,979.99,
043125015108,B14LM658,0,0,0,1039.99,
043125016655,B14LM751,0,0,0,1424.67,
043125015313,B14R001,0,0,0,889.99,
043125015320,B14R002,3,7,10,949.99,
043125016228,B14S001C,6,0,6,809.99,
043125016235,B14S002C,4,0,4,809.99,
043125016242,B14S003C,2,1,3,809.99,
043125015764,B14S101C,0,1,1,684.99,
043125015757,B14S102C,6,0,6,684.99,
043125015856,B14S103C,2,3,5,684.99,
043125015863,B14S104C,0,0,0,684.99,
043125015290,B14S112,9,2,11,754.99,
043125016082,B14S351C,2,0,2,884.99,
043125016099,B14S351LC,6,6,12,909.99,
043125015740,B14S352C,4,0,4,884.99,
043125016105,B14S352LC,8,2,10,909.99,
043125016112,B14S354C,0,0,0,884.99,
043125016136,B14S356C,7,0,7,884.99,
043125015726,B14S359C,4,1,5,929.99,
043125016143,B14S371CF,5,1,6,1369.99,
043125015252,B14S382,1,0,1,979.99,
043125016167,B14S382CF,5,2,7,1369.99,
043125015719,B14S501C,11,3,14,734.99,
043125015771,B14S502C,7,4,11,734.99,
043125015917,B14S503C,2,4,6,734.99,
043125015924,B14S504C,0,0,0,734.99,
043125015788,B14S507C,2,2,4,734.99,
043125015733,B14S509C,3,0,3,734.99,
043125015962,B14S511C,10,1,11,734.99,
043125015979,B14S512C,7,2,9,734.99,
043125015993,B14S521CF,7,2,9,1229.99,
043125015276,B14S522,1,2,3,814.99,
043125016020,B14S522CF,2,0,2,1229.99,
043125015214,B14S651,3,0,3,979.99,
043125015221,B14S652,5,4,9,979.99,
043125016679,B14S751,4,4,8,1424.67,
043125016693,B14S752,8,8,16,1424.67,
043125015207,B14SM359,3,0,3,1039.99,
043125016181,B14SM359CF,0,0,0,1429.99,
043125015238,B14SM519,0,0,0,814.99,
043125016037,B14SM519CF,0,0,0,1229.99,
043125015191,B14SM659,2,1,3,1039.99,
043125016716,B14SM759,0,0,0,1424.67,
043125110087,BMR001,14,6,20,469.99,
043125110094,BMR002,0,0,0,539.99,
043125110100,BMR003,0,2,2,469.99,
043125110117,BMR004,0,0,0,539.99,
043125110131,BMR005,9,4,13,469.99,
043125110148,BMR006,0,0,0,539.99,
043125308286,BPR20-308MC,0,0,0,1379.99,
043125065103,BPR20-65MC,12,17,29,1379.99,
043125065172,BPR20-65MCHB,0,0,0,1379.99,
043125250011,BPR20-250MC,0,0,0,1379.99,
043125300181,BPR20-300MC,1,5,6,1379.99,
043125300235,BPR20-300PRCMC,0,0,0,1439.99,
043125065165,BPR20-65PRC,3,7,10,1439.99,
043125280070,BPR26-28N,0,0,0,1989.99,
043125300433,BPR26-300PRC,0,0,0,1989.99,
043125300426,BPR26-300WM,0,0,0,1939.99,
043125308156,BPR26-308,0,0,0,1939.99,
043125375004,BPR26-375HH,0,0,0,1989.99,
043125065431,BPR26-65CM,0,0,0,1939.99,
043125065448,BPR26-65PRC,0,0,0,1989.99,
043125300358,BPR28-300WM,0,0,0,1729.99,
043125065301,BPR28-65,1,1,2,1729.99,
043125065349,BPR28-65PRC,2,3,5,1789.99,
043125300419,BPR34-300WM,0,0,0,2348.99,
043125308149,BPR34-308,0,0,0,2349.99,
043125065417,BPR34-65CM,0,0,0,2349.99,
043125065424,BPR34-65PRC,0,0,0,2399.99,
043125300457,BPR37-300WM,0,0,0,2585.48,
043125308002,BPR37-308,1,0,1,2585.48,
043125065455,BPR37-65CM,0,0,0,2585.48,
043125065462,BPR37-65PRC,0,0,0,2640.91,
043125110025,BXR001,0,0,0,469.99,
043125110032,BXR002,0,0,0,539.99,
043125000111,BA0002,0,0,0,27.99,
043125000432,BA0016,0,0,0,29.99,
043125065127,BPR22-65F,4,6,10,1799.99,1549.99
810083202044,BP9DTCC,35,18,53,264.99,
810083202037,BP9MCC,17,27,44,264.99,
810083202273,BP9MCCL,0,0,0,344.99,
810083202167,BP90DCC,26,15,41,264.99,
810083202129,BP9PBCC,61,42,103,274.99,
810083202136,BP9PCHCC,0,0,0,274.99,
810083202143,BP9RGCC,13,71,84,274.99,
810083201511,T22DT,25,10,35,244.99,
810083201504,T22M,25,13,38,244.99,
810083201528,T22NKL,30,22,52,254.99,
810083200101,T380BLM8,35,27,62,244.99,
810083200057,T380DT8,0,25,25,244.99,
810083200033,T380M8,12,1,13,244.99,
810083200279,T380M8X,0,0,0,249.99,
810083200361,T380MC,8,4,12,249.99,
810083200040,T380NKL8,11,7,18,254.99,
810083200255,T380PB8,19,47,66,249.99,
810083200439,T380PCH8,37,62,99,249.99,
810083200316,T380PM15X,0,0,0,309.99,
810083200194,THUN380PMC15,32,25,57,304.99,
810083200095,T380PNK8,12,17,29,244.99,
810083200088,T380PRP8,0,0,0,244.99,
810083200262,T380RG8,19,36,55,249.99,
810083200224,THUN380MLTCC,8,10,18,249.99,
810083200163,THUN380PM15,0,0,0,294.99,
810083200170,THUN380PNKL15,0,0,0,314.99,
810083200118,TPR380M,0,0,0,249.99,
810083200446,TPR380PM,10,0,10,299.99,
810083202051,TPR9CM,0,0,0,369.99,
810083202006,TPR9M,10,25,35,369.99,
810083202020,TPR9XT,0,0,0,654.99,
718356159241,BAR15RMFT,15,8,23,609.99,
091664910958,BP9CCMAG,5,2,7,39.99,
810083204321,THUN22BLMAG,0,0,0,,
810083204222,THUN380BLMAG,0,0,0,,
810083204215,THUN380BLMAGFB,20,5,25,,
810083204239,THUN380BLMAGFR,9,0,9,,
091664903929,THUN380DLXBLMAG,0,0,0,31.99,
810083204246,THUN380PM15MAG,0,0,0,,
810083204291,THUN45UCMMAG,13,6,19,,
810083204307,THUN9MHCMAG,1,1,2,,
810083204277,THUN9UCM13MAG,0,0,0,,
648018010811,40IP05BK,4,4,8,15.99,
648018010934,40TP03BK,5,3,8,12.99,
648018010941,40TP04BK,5,3,8,12.99,
648018012877,410500BK-R,0,2,2,32.99,
648018012884,410501BK-R,3,2,5,32.99,
648018013850,410502BK-L,0,0,0,32.99,
648018012891,410502BK-R,13,6,19,32.99,29.99
648018013010,410503BK-R,3,3,6,32.99,
648018013126,410507BK-R,3,3,6,32.99,
648018127267,410510PBK,3,4,7,20.99,
648018014901,410513BK-R,6,2,8,32.99,
648018058059,410525BK-R,3,2,5,32.99,
604544616439,410561BK-R,4,3,7,32.99,
648018219764,410563BK-R,5,4,9,32.99,
604544616248,410568BK-R,3,4,7,32.99,
604544671094,410570BK-R,5,4,9,32.99,
604544671100,410576BK-R,10,4,14,32.99,
604544671117,410577BK-R,6,3,9,32.99,
648018014376,410600PBK,6,4,10,14.99,
648018127281,410610PBK,0,5,5,26.99,
604544647990,410700BKR,3,3,6,39.99,
604544648058,410701BKR,2,0,2,39.99,
604544662795,410707BKR,2,2,4,39.99,
604544648041,410757BKR,2,2,4,39.99,
604544659603,410761ABKR,0,0,0,39.99,
604544662474,410770BKR,1,2,3,39.99,
604544662658,410777BKR,2,2,4,39.99,
604544673494,416000BK,0,1,1,24.99,
604544673500,416002BK,6,6,12,24.99,
604544673593,416049BK,0,1,1,24.99,
604544673562,416063BK,98,77,175,24.99,
604544673517,416068BK,6,3,9,,
604544673531,416070BK,3,2,5,24.99,
604544673524,416076BK,8,2,10,24.99,
604544673548,416078BK,0,0,0,24.99,
604544673708,416102BK,0,2,2,39.99,
604544673715,416168BK,0,0,0,39.99,
604544673722,416176BK,1,2,3,39.99,
604544615586,417502UG,7,29,36,16.99,
604544617849,417525UG,23,1,24,,
604544615593,417563UG,2,2,4,16.99,
604544615715,417568UG,10,0,10,16.99,
604544664164,417570UG,8,3,11,16.99,
604544664171,417576UG,6,2,8,16.99,
604544664188,417578UG,6,2,8,16.99,
604544621594,419000BBR,5,2,7,39.99,
604544621631,419002BBR,6,3,9,39.99,
648018090554,70GS12BK,11,15,26,26.99,
648018127496,70GS15BK,0,0,0,16.99,
648018121128,70GS16BK,15,3,18,28.99,
648018009976,70UT00BK,0,0,0,7.49,
648018175015,71RA01BK,0,0,0,10.99,
648018049576,73IP04BK-R,2,2,4,9.49,
648018090882,73IP05BK-L,2,2,4,9.49,
648018049583,73IP05BK-R,3,2,5,9.49,
648018049590,73IP06BK-R,2,2,4,9.49,
648018090905,73IP07BK-L,2,3,5,9.49,
648018049606,73IP07BK-R,3,2,5,9.49,
648018189470,74SG36BK,39,25,64,39.99,
648018010866,40IP06BK,1,2,3,15.99,
604544662603,410776BKR,4,0,4,,
604544673692,416100BK,3,5,8,,
604544673777,416142BK,2,2,4,39.99,
689585854385,4160003,0,0,0,289.99,
689585855559,525256,0,0,0,239.99,
689585855566,525257,43,38,81,209.99,
713440971198,11238801,0,0,0,29.99,
661120416692,1099442,0,0,0,128.99,
661120416708,1099443,7,14,21,209.99,
661120418245,1100477,9,0,9,26.99,
661120418252,1100478,3,1,4,39.99,
661120418269,1100479,6,0,6,60.99,
661120418405,1100481,0,2,2,64.99,
661120418450,1100483,0,19,19,169.99,
661120079057,1117132,0,4,4,64.99,
661120103813,1134446,0,0,0,153.99,
661120106487,1137118,4,0,4,111.99,
855959003301,BABU45ACP,0,0,0,429.99,
855959001147,BAC2K45/410,11,3,14,449.99,
855959001178,BACD45/410,5,0,5,429.99,
855959002892,BAGR-45/410,26,0,26,319.99,
855959002502,BAM357/38,35,16,51,429.99,
855959006135,BAPA-45/410,15,12,27,519.99,
855959002618,BARII357/38,63,38,101,609.99,
855959001840,BARII45/410,13,10,23,609.99,
855959008955,BARN-45ACP,27,24,51,239.99,
855959001574,BARR45/410,33,17,50,609.99,
855959009983,BARW-45/410,1,27,28,259.99,
855959007408,BASL-22LR,99,99,198,324.99,
855959009761,BASL-380ACP,95,22,117,334.99,
855959001369,BASL-9MM,31,19,50,334.99,
855959002366,BASRS-22LR,99,61,160,229.99,
855959005534,BASRS-380ACP,0,8,8,239.99,
855959005930,BASRS-9MM,0,11,11,239.99,
855959001161,BASS45/410,96,32,128,479.99,
855959001567,BASSIV45/410,49,16,65,519.99,
855959001031,BATD357/38,99,46,145,429.99,379.99
855959001017,BATD45/410,99,68,167,429.99,379.99
855959001109,BATD9MM,71,57,128,429.99,379.99
855959009815,BATP-45/410,78,22,100,569.99,469.99
855959001291,PT2A45/410,6,9,15,699.99,
023614250951,051407490,3,4,7,429.0,
023614250975,051409490,20,40,60,469.0,
023614251552,051421490,14,15,29,509.0,
023614253228,051427490,0,0,0,529.0,
023614251897,051428490,2,6,8,499.0,
023614251903,051429490,7,2,9,499.0,
023614257349,051442490,9,7,16,429.0,
023614259541,051448490,0,4,4,399.0,
023614068204,051461490,7,0,7,529.0,
023614397663,051482490,13,7,20,349.0,
023614397670,051483490,3,2,5,379.0,
023614043386,051498490,14,12,26,349.0,
023614043393,051499490,8,0,8,459.0,
023614444008,051530490,11,8,19,429.0,429.0
023614678502,051534490,7,3,10,469.0,
023614735328,051537490,0,0,0,329.0,
023614735618,051543490,0,0,0,469.0,
023614742517,051562490,15,10,25,619.0,
023614742708,051564490,37,14,51,519.0,
023614850908,051572490,1,3,4,619.0,
023614850915,051573490,8,5,13,599.0,
023614853930,051580490,2,7,9,669.0,
023614853947,051581490,6,1,7,689.0,
023614853954,051582490,0,0,0,789.0,
023614857556,051584490,0,0,0,599.0,
023614857563,051585490,0,0,0,599.0,
023614857570,051586490,0,0,0,429.0,
023614072003,051802490,0,11,11,559.0,
023614072010,051803490,0,0,0,559.0,
023614042389,051814490,2,6,8,579.0,
023614044178,051820490,0,0,0,649.0,
023614443728,051851490,0,0,0,599.0,
023614742715,051879490,0,0,0,549.0,
023614742722,051880490,0,0,0,549.0,
023614857587,051893490,0,0,0,599.0,
023614857594,051894490,0,0,0,599.0,
023614857600,051895490,0,0,0,599.0,
023614857617,051896490,0,0,0,599.0,
023614857624,051897490,0,0,0,599.0,
023614857631,051898490,0,0,0,599.0,
023614044451,051904492,11,16,27,599.0,
023614044468,051905492,1,3,4,599.0,
023614443742,051912492,9,0,9,709.0,
023614443759,051913492,0,0,0,709.0,
023614850984,051969492,0,0,0,709.0,
023614850991,051970492,0,0,0,709.0,
023614851004,051971492,0,0,0,789.0,
023614851011,051972492,0,0,0,789.0,
023614857648,051985492,0,0,0,709.0,
023614857655,051986492,0,0,0,709.0,
023614857662,051987492,0,0,0,709.0,
023614857679,051988492,0,0,0,709.0,
023614857686,051989492,0,0,0,709.0,
023614857693,051990492,0,0,0,709.0,
023614743446,011294113,0,0,0,1489.0,
023614443148,011412605,0,0,0,989.0,
023614443162,011413304,0,0,0,939.0,
023614443186,011413604,0,0,0,989.0,
023614686798,011417204,0,0,0,939.0,
023614686774,011417304,0,0,0,889.0,
023614735281,011420205,0,0,0,999.99,
023614739081,011426205,0,0,0,1039.99,
023614743255,011428205,0,0,0,1039.99,
023614849285,011430205,0,0,0,1039.99,
023614849315,011431204,0,0,0,999.0,
023614853077,011433321,0,0,0,1099.0,
023614853312,011434204,0,0,0,1039.99,
023614853305,011434205,0,0,0,1039.99,
023614853336,011435204,0,0,0,999.99,
023614853329,011435205,0,0,0,999.99,
023614740735,011700304,0,0,0,1279.0,
023614740797,011701204,0,0,0,1529.0,
023614997658,011702204,33,8,41,1529.99,
023614997641,011702205,6,1,7,1529.99,
023614997696,011704204,33,11,44,1529.99,
023614740896,011705204,32,4,36,1669.0,
023614997573,011706204,0,3,3,1669.99,
023614997566,011706205,0,0,0,1669.99,
023614740957,011708303,0,0,0,1499.0,
023614740940,011708304,0,0,0,1499.0,
023614997610,011732204,3,3,6,1669.99,
023614744061,011735304,0,3,3,1289.0,
023614997559,011739204,0,0,0,1669.0,
023614997634,011740204,5,2,7,1529.0,
023614849445,011742204,1,0,1,1529.99,
023614849421,011743204,0,0,0,1669.99,
023614853589,011748205,0,0,0,1599.0,
023614853343,011745321,0,0,0,1449.0,
023614853299,011746204,0,0,0,1529.99,
023614853282,011746205,0,0,0,1529.99,
023614853275,011747204,0,0,0,1669.99,
023614853268,011747205,0,0,0,1669.99,
023614855859,011753321,0,0,0,1449.0,
023614857464,011764204,0,0,0,1669.99,
023614857488,011765204,0,0,0,1529.99,
023614072096,0118003004,0,0,0,1419.0,
023614072089,0118003005,0,0,0,1419.0,
023614439585,0118005004,0,0,0,1469.0,
023614439578,0118005005,0,0,0,1469.0,
023614398226,0118203004,0,0,0,1729.0,
023614997351,0118255004,0,0,0,1579.0,
023614997276,0118475004,0,0,0,1759.99,
023614997269,0118475005,0,0,0,1759.99,
023614743309,0119002004,0,0,0,1699.0,
023614997252,0119005004,0,0,0,1759.99,
023614997245,0119005005,0,0,0,1759.99,
023614743552,0119015004,0,0,0,1429.0,
023614743545,0119015005,0,0,0,1429.0,
023614997511,0119072004,0,0,0,1699.0,
023614997535,0119082004,0,0,0,1529.0,
023614853176,0119112004,0,0,0,1699.99,
023614853169,0119112005,0,0,0,1699.99,
023614853190,0119115004,0,0,0,1759.99,
023614853183,0119115005,0,0,0,1759.99,
023614853213,0119122004,0,0,0,1529.99,
023614853237,0119125004,0,0,0,1579.0,
023614737919,012286304,0,0,0,599.0,
023614737902,012286305,0,0,0,599.0,
023614737957,012286604,0,0,0,619.0,
023614737940,012286605,0,0,0,619.0,
023614741305,012286814,0,0,0,649.0,
023614741329,012286914,0,0,0,649.0,
023614741206,012289113,0,0,0,649.0,
023614738060,012289204,0,0,0,589.0,
023614738046,012289304,3,0,3,569.0,
023614740612,012289604,3,0,3,589.0,
023614073192,0135313009,0,0,0,2639.0,
023614073185,0135313010,0,0,0,2639.0,
023614400455,0135316010,0,0,0,2639.0,
023614043980,013531812,0,0,0,2689.0,
023614396598,0135533009,0,0,0,2959.0,
023614396604,0135533010,0,0,0,2959.0,
023614398295,0135793009,0,0,0,2799.0,
023614398318,0135803009,0,0,0,3139.0,
023614400684,0136243009,0,0,0,3029.0,
023614236917,017054401,0,0,0,1249.0,
023614442226,017081401,0,0,0,1589.0,
023614735250,017087401,0,0,0,4469.0,
023614443018,018073302,0,0,0,1889.0,
023614443001,018073303,0,0,0,1889.0,
023614442998,018073304,0,0,0,1889.0,
023614443032,018073603,0,0,0,1889.0,
023614443025,018073604,0,0,0,1889.0,
023614443216,018074327,0,0,0,1949.0,
023614737063,0180766005,0,0,0,2199.0,
023614681465,018111303,0,0,0,2189.0,
023614679387,018115303,0,0,0,1839.0,
023614679370,018115304,0,0,0,1839.0,
023614679424,018117304,0,0,0,2739.0,
023614744047,018117513,0,0,0,2799.99,
023614735120,018142304,0,0,0,2199.0,
023614737421,018142604,0,0,0,2199.0,
023614737445,018142813,1,0,1,2259.0,
023614737469,018142913,0,0,0,2259.0,
023614735496,018148303,0,0,0,2049.99,
023614735526,018149303,0,0,0,2399.99,
023614736646,0181624009,0,0,0,4809.0,
023614736745,018163304,0,0,0,2359.0,
023614736752,018163605,0,0,0,2359.0,
023614736660,0181653004,0,0,0,2139.0,
023614736684,0181656004,0,0,0,2139.0,
023614736707,018165813,0,0,0,2199.0,
023614736721,018165913,4,0,4,2199.0,
023614737667,018183302,0,0,0,1989.99,
023614737698,018184302,0,0,0,2319.99,
023614737681,018184303,0,0,0,2319.99,
023614740674,0182093004,0,0,0,2259.0,
023614740698,0182096004,0,0,0,2259.0,
023614744528,018258304,0,0,0,1629.0,
023614744566,018258604,0,0,0,1629.0,
023614744580,018258813,0,0,0,1679.0,
023614744597,018258914,0,0,0,1679.0,
023614744627,018259304,0,0,0,1789.0,
023614744665,018259604,0,0,0,1789.0,
023614744689,018259813,0,0,0,1839.0,
023614744696,018259914,0,0,0,1839.0,
023614440840,018709303,0,0,0,1549.0,
023614679172,018709304,0,0,0,1549.0,
023614440864,018710303,0,0,0,1469.0,
023614739296,018719203,0,0,0,1929.99,
023614737742,018719204,0,0,0,1929.99,
023614743347,018722203,0,0,0,1929.0,
023614743330,018722204,0,0,0,1929.0,
023614849353,018725304,0,0,0,1929.0,
023614852377,018728306,0,0,0,1969.0,
023614853374,018729203,0,0,0,1929.99,
023614853367,018729204,0,0,0,1929.99,
023614853350,018729205,0,0,0,1929.99,
023614025559,021001102,0,0,0,589.0,
023614824831,021002102,0,0,0,1349.0,
023614824848,021003102,0,0,0,1349.0,
023614736592,021023102,0,0,0,839.0,
023614855842,011438204,0,0,0,1039.99,
023614025474,024100103,0,0,0,619.0,
023614025481,024101103,0,0,0,709.0,
023614243816,024105155,0,0,0,979.0,
023614250197,024107102,0,0,0,649.0,
023614250203,024108102,0,0,0,769.0,
023614071242,024115103,0,0,0,579.0,
023614252733,025175202,0,0,0,599.0,
023614257943,025175270,0,0,0,629.0,
023614255222,025176202,0,0,0,619.0,
023614257950,025176204,0,0,0,639.0,
023614257967,025176270,2,0,2,639.0,
023614686682,025236202,0,0,0,749.0,
023614686705,025236270,0,0,0,789.0,
023614856986,025252202,0,0,0,679.0,
023614856375,025253202,0,0,0,699.0,
023614856382,025253204,0,0,0,729.0,
023614856399,025253270,0,0,0,729.0,
023614856993,025256202,0,0,0,629.0,
023614287001,031001218,0,0,0,1239.0,
023614074939,031001223,0,0,0,1239.0,
023614286974,031001224,0,0,0,1239.0,
023614286998,031001226,0,0,0,1239.0,
023614439646,031047211,0,0,0,1099.0,
023614439660,031047218,0,0,0,1099.0,
023614439691,031047224,0,0,0,1099.0,
023614439707,031047226,0,0,0,1099.0,
023614439721,031047229,0,0,0,1189.0,
023614439752,031048218,0,0,0,1099.0,
023614439790,031048226,0,0,0,1099.0,
023614439813,031048229,0,0,0,1189.0,
023614443537,031054218,0,0,0,1279.0,
023614736790,031065218,0,0,0,1309.0,
023614852414,031072218,0,0,0,1359.0,
023614852421,031072224,0,0,0,1359.0,
023614852438,031072226,0,0,0,1359.0,
023614852469,031072227,0,0,0,1439.0,
023614852476,031072229,0,0,0,1439.0,
023614240655,034006118,0,0,0,839.0,
023614240341,034006124,0,0,0,889.0,
023614240365,034006126,0,0,0,889.0,
023614741510,034006182,0,0,0,839.0,
023614250029,034009111,0,0,0,889.0,
023614250043,034009118,0,0,0,889.0,
023614249986,034009126,0,0,0,929.0,
023614250005,034009129,0,0,0,929.0,
023614741534,034009182,0,0,0,889.0,
023614259602,034015118,0,0,0,1049.0,
023614259701,034015129,0,0,0,1099.0,
023614741527,034015182,0,0,0,1049.0,
023614066620,034018118,0,0,0,949.0,
023614741541,034018182,0,0,0,949.0,
023614258155,035200218,0,0,0,909.0,
023614258216,035200224,0,0,0,909.0,
023614258230,035200226,0,0,0,909.0,
023614258254,035200229,0,0,0,939.0,
023614442844,035200282,0,0,0,909.0,
023614257998,035208211,0,0,0,809.0,
023614258681,035208216,0,0,0,809.0,
023614258001,035208218,0,0,0,809.0,
023614258063,035208224,0,0,0,809.0,
023614258087,035208226,0,0,0,809.0,
023614258094,035208227,0,0,0,839.0,
023614258100,035208229,0,0,0,839.0,
023614442820,035208282,0,0,0,809.0,
023614067283,035235218,0,0,0,1239.0,
023614067351,035235224,0,0,0,1239.0,
023614067375,035235226,0,0,0,1239.0,
023614067399,035235229,0,0,0,1269.0,
023614442905,035235282,0,0,0,1239.0,
023614071587,035255218,0,0,0,829.0,
023614071679,035255226,0,0,0,829.0,
023614442837,035255282,0,0,0,829.0,
023614679318,035438218,4,0,4,1059.0,
023614679349,035438227,0,0,0,1099.0,
023614679363,035438229,0,0,0,1099.0,
023614679301,035438282,16,4,20,1059.0,
023614738077,035438294,0,0,0,1099.0,
023614851295,035438299,0,1,1,1099.0,
023614739883,035496218,0,0,0,749.0,
023614739906,035496224,0,0,0,749.0,
023614739920,035496226,0,0,0,749.0,
023614739951,035496227,0,0,0,789.0,
023614739968,035496229,9,0,9,789.0,
023614739869,035496282,0,2,2,749.0,
023614740049,035497218,0,0,0,979.0,
023614740063,035497224,0,0,0,979.0,
023614740087,035497226,0,2,2,979.0,
023614740117,035497227,0,4,4,1009.0,
023614740124,035497229,0,0,0,1009.0,
023614740025,035497282,0,0,0,979.0,
023614997788,035531282,1,7,8,989.99,
023614997795,035531294,5,5,10,1019.99,
023614849551,035538226,0,0,0,1959.0,
023614849568,035538227,0,0,0,1979.0,
023614849582,035538229,0,2,2,1979.0,
023614849537,035538246,0,0,0,1979.0,
023614849506,035538282,7,2,9,1959.0,
023614849575,035538288,0,0,0,1999.0,
023614849605,035538297,0,0,0,1979.0,
023614857266,035538298,0,0,0,1979.0,
023614849513,035538299,2,0,2,1979.0,
023614849674,035539227,2,1,3,2009.0,
023614849698,035539229,0,1,1,2009.0,
023614849643,035539282,0,0,0,1989.0,
023614849681,035539288,0,0,0,2029.0,
023614849711,035539297,2,0,2,2009.0,
023614849650,035539299,0,0,0,2009.0,
023614849803,035540226,0,0,0,1959.0,
023614849810,035540227,4,3,7,1979.0,
023614849834,035540229,2,1,3,1979.0,
023614849780,035540246,0,0,0,1979.0,
023614849759,035540282,4,2,6,1959.0,
023614849827,035540288,0,0,0,1999.0,
023614849858,035540297,1,0,1,1979.0,
023614849766,035540299,3,2,5,1979.0,
023614849940,035541229,1,0,1,2009.0,
023614849896,035541282,0,0,0,1989.0,
023614849933,035541288,0,0,0,2029.0,
023614849964,035541297,0,0,0,2009.0,
023614849902,035541299,0,0,0,2009.0,
023614850007,035542282,2,2,4,1739.0,
023614857396,035542298,0,0,0,1759.0,
023614850014,035542299,0,0,0,1759.0,
023614850137,035543282,4,1,5,1769.0,
023614850199,035543229,0,0,0,1789.0,
023614850144,035543299,0,0,0,1789.0,
023614850434,035544229,1,2,3,2139.0,
023614850359,035544282,1,2,3,2109.0,
023614850441,035544297,3,0,3,2139.0,
023614850368,035544299,0,0,0,2139.0,
023614850632,035545229,0,0,0,2159.0,
023614850571,035545282,2,2,4,2139.0,
023614850625,035545288,0,0,0,2189.0,
023614850649,035545297,0,0,0,2159.0,
023614850588,035545299,0,0,0,2159.0,
023614852490,035554224,0,0,0,889.0,
023614852537,035554227,0,0,0,919.0,
023614852551,035554229,1,0,1,919.0,
023614852483,035554282,2,1,3,889.0,
023614852520,035554299,0,0,0,919.0,
023614852711,035555227,0,0,0,1209.0,
023614852735,035555229,2,0,2,1209.0,
023614852674,035555282,0,0,0,1189.0,
023614852698,035555294,3,0,3,1209.0,
023614852766,035555297,0,0,0,1209.0,
023614852704,035555299,0,0,0,1209.0,
023614852629,035556227,0,0,0,1929.0,
023614852636,035556229,2,0,2,1929.0,
023614852575,035556282,1,0,1,1879.0,
023614852605,035556299,0,0,0,1929.0,
023614855989,035557224,0,0,0,1049.0,
023614853015,035557227,0,0,0,1089.0,
023614853039,035557229,0,0,0,1089.0,
023614853008,035557246,0,0,0,1089.0,
023614852957,035557282,3,0,3,1049.0,
023614853022,035557288,0,0,0,1119.0,
023614853053,035557297,0,0,0,1089.0,
023614857242,035557298,0,0,0,1089.0,
023614852988,035557299,0,0,0,1089.0,
023614852810,035558218,0,0,0,1029.0,
023614852827,035558224,0,0,0,1029.0,
023614852834,035558226,0,0,0,1029.0,
023614852896,035558227,0,0,0,1059.0,
023614852919,035558229,0,0,0,1059.0,
023614852889,035558246,0,0,0,1059.0,
023614852797,035558282,0,0,0,1029.0,
023614852902,035558288,0,0,0,1089.0,
023614852858,035558294,0,0,0,1059.0,
023614852933,035558297,0,0,0,1059.0,
023614857228,035558298,0,0,0,1059.0,
023614852865,035558299,0,0,0,1059.0,
023614853602,035559218,0,0,0,1059.0,
023614853619,035559227,0,0,0,1099.0,
023614853633,035559229,2,0,2,1099.0,
023614853596,035559282,1,2,3,1059.0,
023614853770,035559297,0,0,0,1099.0,
023614857235,035559298,0,0,0,1099.0,
023614853763,035559299,0,0,0,1099.0,
023614853695,035560218,2,0,2,1289.0,
023614853688,035560282,3,0,3,1289.0,
023614856764,035581218,0,0,0,1349.0,
023614856726,035581282,0,0,0,1349.0,
023614856061,035582218,0,0,0,1989.0,
023614856160,035582229,0,0,0,2009.0,
023614856047,035582282,0,0,0,1989.0,
023614856184,035582297,0,0,0,2009.0,
023614857280,035582298,0,0,0,2009.0,
023614856771,035587218,0,0,0,1329.0,
023614856757,035587282,0,0,0,1329.0,
023614857020,035588282,0,0,0,989.0,
023614857075,035588297,0,0,0,1019.0,
023614857051,035588298,0,0,0,1019.0,
023614400929,035800218,0,0,0,509.0,
023614398240,035800224,0,0,0,509.0,
023614398257,035800226,0,0,0,509.0,
023614398264,035800227,0,0,0,509.0,
023614398271,035800229,0,0,0,509.0,
023614442301,035800282,0,0,0,509.0,
023614058717,035801218,0,0,0,579.0,
023614400608,035801224,0,0,0,579.0,
023614400615,035801226,0,0,0,579.0,
023614400639,035801229,0,0,0,579.0,
023614442295,035801282,0,0,0,579.0,
023614442813,035808282,0,0,0,509.0,
023614975984,112025024,0,0,0,52.99,
023614199526,112025050,0,0,0,52.99,
023614843825,112044506,11,5,16,43.99,
023614971023,112044508,5,0,5,43.99,
023614971054,112044511,0,0,0,43.99,
023614048183,112044601,3,1,4,37.99,
023614048213,112044602,6,1,7,37.99,
023614415534,112044607,6,7,13,37.99,
023614951247,112044609,6,2,8,37.99,
023614962038,112044612,1,7,8,37.99,
023614970729,112044614,8,0,8,37.99,
023614644736,112050293,0,0,0,52.99,
023614025290,112055190,0,0,0,28.99,
023614370123,112055191,0,0,0,34.99,
023614415541,112055192,44,16,60,27.99,
023614203964,112055290,0,3,3,39.99,
023614048091,112055291,0,0,0,39.99,
023614042402,051816490,37,0,37,599.0,
023614062400,051507490,10,0,10,509.0,
023614062530,051508490,14,12,26,519.0,
023614850953,051890490,6,5,11,499.99,
023614740773,011701304,0,0,0,1449.0,
023614740872,011705304,0,0,0,1559.0,
023614997436,0119053004,0,0,0,1579.99,
023614997450,0119055004,0,0,0,1579.99,
023614997412,0119063004,0,0,0,1679.99,
023614853206,0119122005,0,0,0,1529.99,
023614744153,012292914,0,0,0,559.99,
023614398332,0135813009,0,0,0,2799.99,
023614737650,018183303,0,0,0,1989.99,
023614739302,0181993010,0,0,0,2959.99,
023614744542,018258513,1,5,6,1679.99,
023614997238,018724303,1,0,1,1789.99,
023614735014,021022102,0,0,0,719.99,
023614741169,021024102,0,0,0,749.0,
023614735021,024127103,0,0,0,689.99,
023614744184,025251202,0,0,0,539.0,
023614744207,025251270,0,0,0,569.0,
023614240624,034006109,0,0,0,839.0,
023614240648,034006116,0,0,0,839.0,
023614997740,034036118,0,0,0,1209.99,
023614258148,035200211,0,0,0,909.0,
023614258247,035200227,0,0,0,939.0,
023614258056,035208223,0,0,0,809.0,
023614258070,035208225,0,0,0,809.0,
023614071693,035255229,0,0,0,859.0,
023614679356,035438288,0,0,0,1129.0,
023614744788,035528288,0,0,0,869.99,
023614744801,035528297,0,0,0,849.99,
023614744818,035528299,0,0,0,849.99,
023614997832,035531297,0,0,0,1019.99,
023614852995,035557248,0,0,0,1089.0,
023614852964,035557283,0,0,0,1089.0,
023614852872,035558248,0,0,0,1059.0,
023614852841,035558283,0,0,0,1059.0,
023614970736,112044615,6,9,15,37.99,
023614850878,051569490,0,0,0,359.99,
023614853657,051578490,0,99,99,409.99,384.99
023614735298,011420204,9,3,12,999.99,
023614739098,011426204,0,0,0,1039.99,
023614743262,011428204,0,0,0,1039.99,
023614398387,0135833009,0,0,0,2639.99,
023614744030,018117514,1,0,1,2799.99,
023614744023,018142513,0,0,0,2249.99,
023614744016,018142514,0,0,0,2249.99,
023614735502,018148302,0,0,0,2049.99,
023614735489,018148304,0,0,0,2049.99,
023614735533,018149302,0,0,0,2399.99,
023614743804,018161304,0,0,0,1509.0,
023614736905,018161604,0,1,1,1509.0,
023614743811,018161813,0,4,4,1559.0,
023614743828,018161913,29,5,34,1559.0,
023614737612,018181327,0,0,0,2099.99,
023614737636,018182327,0,0,0,2459.99,
023614739319,0181993009,0,0,0,2959.99,
023614743477,0182403009,0,0,0,2629.99,
023614743460,0182403010,0,0,0,2629.99,
023614743484,0182413010,0,0,0,2959.99,
023614743491,0182413009,0,0,0,2959.99,
023614744177,0182463009,0,0,0,2739.99,
023614744160,0182463010,0,0,0,2739.99,
023614854623,018321303,0,0,0,6299.0,
023614997221,018724304,1,2,3,1789.99,
023614744795,035528229,0,0,0,849.99,
023614744740,035528282,0,0,0,829.99,
023614744764,035528294,0,0,0,849.99,
023614985457,3220318B,0,0,0,,
023614985440,3220319B,0,0,0,,
023614985471,3220322B,0,0,0,,
023614985495,3220323B,0,0,0,,
023614978817,3220324B,55,25,80,,
023614978800,3220329B,36,17,53,,
023614985334,3220337,0,0,0,,
023614985341,3220338,0,0,0,,
023614978787,3220364B,0,0,0,,
023614985327,3220419,0,0,0,,
023614978756,3220431,0,1,1,,
023614978824,3220432,7,3,10,,
023614982777,3220434B,0,0,0,,
023614985389,3220443B,0,0,0,,
023614978794,3220444B,19,6,25,,
023614985365,3220459B,0,0,0,,
023614985426,3220462B,0,0,0,,
661120079903,1112554,88,12,100,,
661120414254,1085875,31,17,48,,
661120414261,1085876,32,23,55,,
661120416111,1095704,37,15,52,,
661120416128,1095705,62,7,69,,
661120106166,1135880,99,4,103,,
661120079545,1991724,43,9,52,,
794504877731,BB1-7F,71,8,79,,
794504877830,BB1-9F,14,10,24,,
696859308444,BB1-9TF,22,10,32,,
000381260017,626001,99,78,177,2.82,
000381260505,626050,6,5,11,6.58,
000381260628,626062,0,0,0,12.22,
000381260635,626063,0,1,1,12.22,
000381001337,200133,4,4,8,1423.16,
000381001559,200155,11,13,24,1583.9,
000381002006,200200,0,0,0,718.16,
000381002181,200218,4,3,7,206.8,
000381002792,200279,10,5,15,310.2,
000381002990,200299,12,5,17,334.64,
000381004727,200472,15,14,29,297.04,
000381004758,200475,12,10,22,487.86,
000381004802,200480,2,4,6,,
000381004819,200481,1,1,2,,
000381004857,200485,13,14,27,146.64,
000381004864,200486,35,24,59,,
000381004871,200487,16,17,33,146.64,
000381004888,200488,8,9,17,217.14,
000381004895,200489,25,20,45,,
000381004901,200490,17,17,34,193.64,
000381004918,200491,23,20,43,,
000381004925,200492,22,20,42,,
000381004932,200493,5,4,9,278.24,
000381004949,200494,14,10,24,325.24,
000381004956,200495,12,12,24,,
000381004963,200496,11,12,23,387.28,
000381004970,200497,10,12,22,387.28,
000381006219,200621,2,1,3,511.36,
000381006363,200636,4,2,6,626.04,
000381301024,300102,1,0,1,1315.06,
000381302151,300215,1,2,3,239.7,
000381302342,300234,0,0,0,186.12,
000381302366,300236,4,6,10,186.12,
000381302601,300260,87,10,97,145.7,
000381302625,300262,1,2,3,316.78,
000381302632,300263,8,5,13,381.64,354.72
000381302991,300299,0,0,0,807.46,
000381303516,300351,10,10,20,242.52,
000381103413,410341,6,12,18,72.38,
000381103420,410343,39,14,53,72.38,
000381103529,410352,7,7,14,102.46,
000381103536,410353,7,8,15,119.38,
000381106001,410600,14,13,27,16.92,
000381106155,410615,0,0,0,16.92,
000381106209,410620,10,7,17,16.92,
000381106254,410625,2,7,9,16.92,
000381200440,420044,14,14,28,29.14,
000381200778,420077,8,16,24,29.14,
000381200839,420083,28,10,38,22.56,
000381200846,420084,78,24,102,22.56,
000381200877,420087,37,20,57,22.56,
000381201409,420140,17,9,26,35.72,
000381201645,420164,6,5,11,47.94,
000381201812,420181,19,9,28,44.18,
000381201829,420182,7,9,16,44.18,
000381205544,420554,5,10,15,,
000381205568,420556,5,10,15,,
000381205889,420588,4,0,4,42.3,
000381260062,626006,2,5,7,27.26,
029757764133,BUS764124,63,0,63,,
810042110557,BH68300,13,0,13,37.99,
810042110755,BH68311,22,0,22,22.99,
810042111172,BM68450,34,12,46,22.99,
810042111691,BM68450-PNK,65,1,66,22.99,
810042111721,HD68800,39,0,39,,
661120017776,101777,0,0,0,77.99,
661120015574,1071001,30,0,30,24.99,
661120413028,1081950,46,0,46,40.99,
661120413035,1081951,0,0,0,44.99,
661120413042,1081952,5,0,5,89.99,
661120413059,1081953,0,0,0,89.99,
661120413066,1082222,0,1,1,98.99,
661120413073,1082223,0,2,2,98.99,
661120416166,1092515,0,0,0,89.99,
661120416272,1092516,11,0,11,98.99,
661120417767,1099596,15,0,15,65.99,49.99
661120417910,1099602,0,0,0,32.99,30.99
661120417903,1099603,0,0,0,32.99,30.99
661120100027,110002,0,0,0,35.99,
661120000402,110033,2,0,2,94.99,
661120001553,110140,80,53,133,33.99,
661120001560,110141,0,0,0,35.99,
661120075745,1101672,0,0,0,32.99,30.99
661120075691,1102673,2,10,12,94.99,84.99
661120418696,1103306,0,0,0,32.99,30.99
661120418702,1103307,0,0,0,32.99,30.99
661120079293,1108763,0,0,0,32.99,30.99
661120081432,1121933,2,2,4,,
661120103592,1131995,0,0,0,15.99,14.99
661120103691,1131996,0,0,0,15.99,14.99
661120259961,1136234,0,0,0,109.99,99.99
661120210665,121066,10,10,20,10.99,9.99
661120280347,128034,0,0,0,19.99,18.99
661120335658,133565,0,0,0,22.99,
661120470724,147072,0,29,29,21.99,
661120725053,172505,11,2,13,10.99,9.99
661120957812,195781,0,0,0,3.79,
661120986041,198604,0,0,0,4.49,
661120445616,244561,0,0,0,5.99,5.29
661120471424,247142,0,0,0,40.99,
661120803416,280341,0,0,0,19.99,18.99
661120082149,308214,0,0,0,10.99,10.99
661120232254,323225,0,7,7,35.99,
661120001447,336677,0,0,0,192.99,
661120974888,397488,0,16,16,47.99,
661120128038,412803,0,0,0,10.99,9.99
661120871118,487111,0,0,0,26.99,25.99
661120875574,487557,0,0,0,26.99,19.99
661120952534,495253,0,0,0,9.99,8.99
661120354239,535423,2,6,8,12.99,
661120486640,548664,0,0,0,24.99,
661120500100,550010,14,15,29,3.49,2.99
661120692300,569230,18,0,18,40.99,
661120714293,571429,0,0,0,42.99,
661120864851,586485,25,17,42,5.99,5.49
661120357056,635705,3,3,6,53.99,
661120014171,701417,0,1,1,44.99,
661120070559,707055,6,7,13,18.99,17.99
661120108948,810894,0,0,0,6.99,5.99
661120001430,820310,0,0,0,128.99,
661120023654,902365,0,0,0,22.99,
661120393337,939333,0,0,0,26.99,
661120311232,531123,0,20,20,47.99,29.99
787450382329,HG3774G-N,19,0,19,419.99,
787450524484,HG4863-N,9,0,9,299.99,
787450524491,HG4863D-N,0,0,0,299.99,
787450528277,HG4869-N,0,1,1,339.99,
787450524842,HG4869T-N,0,0,0,339.99,
787450525061,HG4873-N,0,0,0,319.99,
787450525092,HG4873B-N,0,0,0,319.99,
787450545823,HG4950-N,0,0,0,609.99,
787450796331,HG561DBR-N,99,99,198,399.99,
787450596733,HG5610T-N,0,0,0,344.99,
787450796287,HG5610WG-N,14,51,65,399.99,
787450606951,HG5632-N,11,9,20,419.99,
787450607651,HG5635-N,0,0,0,444.99,
787450607675,HG5636-N,0,6,6,409.99,
787450839014,HG5636BLC-N,0,0,0,444.99,
787450843226,HG5636DGYD-N,19,6,25,444.99,
787450838956,HG5636GNB-N,57,36,93,444.99,439.99
787450838994,HG5636GND-N,0,0,0,,
787450839021,HG5636GYC-N,34,34,68,459.99,
787450839052,HG5636WBL-N,99,73,172,474.99,
787450839069,HG5636WGN-N,99,84,183,474.99,
787450607699,HG5637-N,18,38,56,409.99,
787450608917,HG5643-N,0,0,0,344.99,
787450681392,HG6481D-N,0,0,0,599.99,
787450719583,HG6594-N,0,9,9,449.99,
787450719590,HG6595-N,0,0,0,409.99,
787450766334,HG6610T-N,0,0,0,541.99,
787450774643,HG6815-N,0,0,0,541.99,
787450848481,HG7010-N,0,0,0,734.99,
787450848504,HG7010C-N,0,0,0,784.99,
787450811188,HG7159-N,25,38,63,409.99,
787450850675,HG7607-N,0,0,0,859.99,
787450850705,HG7607C-N,0,0,0,909.99,
787450850880,HG7609-N,0,0,0,,
787450850897,HG7610-N,0,0,0,619.99,
787450852563,HG7620-N,0,0,0,354.99,
787450859067,HG7620BD-N,0,0,0,354.99,
787450858893,HG7620D-N,0,0,0,354.99,
787450810969,HGP7156-N,0,0,0,499.99,
787450810990,HGP7157-N,0,0,0,524.99,
787450297463,MA548,90,51,141,27.99,
787450297487,MA550,50,0,50,29.99,
787450426740,MA595,0,2,2,27.99,
021205000046,00004,4,0,4,,
021205000138,00013,29,10,39,,
021205000299,00029,53,32,85,,
021205000312,00031,2,16,18,,
021205000329,00032,72,20,92,,
021205000350,00035,0,14,14,,
021205000428,00042,0,0,0,,
021205000466,00046,70,40,110,,
021205000480,00048,0,0,0,,
021205000794,00079,0,0,0,,
021205000817,00081,0,0,0,,
021205000831,00083,0,0,0,,
021205000923,00092,85,35,120,,
021205000954,00095,78,19,97,,
021205001067,00106,0,0,0,,
021205001203,00120,0,0,0,,
021205001289,00128,0,12,12,,
021205001333,00133,0,1,1,,
021205001357,00135,80,20,100,,
021205001616,00161,43,16,59,,
021205001647,00164,89,40,129,,
021205001784,00178,0,0,0,,
021205001890,00189,0,0,0,,
021205002040,00204,0,0,0,,
021205002538,00253,77,39,116,,
021205002606,00260,0,0,0,,
021205002637,00263,0,0,0,,
021205003344,00334,81,20,101,,
021205003627,00362,0,0,0,,
021205003795,00379,0,0,0,,
021205003818,00381,0,0,0,,
021205007816,00781,0,0,0,,
021205007830,00783,0,0,0,,
021205007861,00786,0,0,0,,
021205007922,00792,0,0,0,,
021205010588,01058,0,0,0,,
021205028002,02800,13,11,24,,
021205028064,02806,0,0,0,,
021205035789,03578,55,20,75,,
021205036939,03693,0,0,0,,
021205255897,25589-CAE,0,0,0,,
021205255965,25596,0,0,0,,
021205258805,25880,44,21,65,,
021205258812,25881,34,21,55,,
021205258829,25882,42,16,58,,
021205258836,25883,50,20,70,,
021205258850,25885,46,19,65,,
021205258867,25886,40,15,55,,
021205581828,58182,36,0,36,,
021205581859,58185,0,0,0,,
021205584133,58413,0,0,0,,
021205584140,58414-CAE,0,0,0,,
021256018090,60180,0,0,0,,
021205601847,60184,0,0,0,,
021205601854,60185,0,0,0,,
021205646596,64659,34,20,54,,
021205646602,64660,46,20,66,,
021205646619,64661,50,20,70,,
021205646626,64662,50,20,70,,
021205646633,64663,33,15,48,,
021205646640,64664,0,0,0,,
021205646657,64665,28,21,49,,
021205646718,64671,0,0,0,,
021205646923,64692,49,20,69,,
021205646961,64696,40,15,55,,
021205653051,65305,0,0,0,,
021205653105,65310,0,0,0,,
787450829541,HG6034A-N,6,10,16,1124.99,
787450829565,HG6035A-N,6,10,16,1124.99,
787450512832,RI3291-N,0,5,5,609.99,
787450534575,RI3291CC-N,1,3,4,,
787450657373,RI4088-N,6,99,105,879.99,
787450693135,RI4317-N,0,0,0,749.99,
787450721784,RI4335-N,7,0,7,789.99,
787450797918,RI4416-N,0,2,2,749.99,
787450810488,RI4577-N,0,5,5,749.99,
678958135206,13520,0,0,0,339.99,
678958138115,13811,8,0,8,284.99,
678958138207,13820,17,5,22,279.99,
678958144208,14420,8,19,27,359.99,
678958144291,14429,22,14,36,379.99,
678958238723,23872,62,28,90,399.99,
678958253870,25387,24,65,89,369.99,
678958344318,34431,0,0,0,389.99,
678958523300,52330,0,0,0,334.99,
678958523409,52340-CHT,0,0,0,334.99,
678958532111,53211,6,7,13,324.99,
678958532210,53221,15,16,31,334.99,
678958536201,53620-CHT,0,0,0,319.99,
678958536300,53630,39,19,58,319.99,
678958538113,53811,99,19,118,314.99,
678958538205,53820,25,41,66,309.99,
678958538212,53821,3,11,14,309.99,
678958538243,53824,63,28,91,314.99,
678958538304,53830,0,4,4,314.99,
678958538311,53831,43,19,62,314.99,
678958538397,53839,75,28,103,359.99,
678958538403,53840,59,20,79,314.99,
678958538410,53841,29,16,45,314.99,
678958538496,53849,7,4,11,359.99,
678958538519,53851,22,3,25,319.99,
678958538540,53854,2,33,35,319.99,
678958538601,53860,10,8,18,314.99,
678958538649,53864,11,16,27,314.99,
678958538793,53879,74,39,113,324.99,
678958632705,63270,0,0,0,409.99,
678958644203,64420,0,0,0,379.99,
678958722246,72224,0,0,0,324.99,
678958722420,72242,0,0,0,344.99,
678958722437,72243,0,0,0,379.99,
678958723243,72324,0,0,0,324.99,
678958723427,72342,0,0,0,344.99,
678958732207,73220,57,28,85,324.99,
678958735208,73520,0,0,0,339.99,
678958735215,73521,0,0,0,339.99,
678958735420,73542,0,0,0,379.99,
678958738025,73802,7,7,14,354.99,
678958738209,73820,9,69,78,299.99,
678958738292,73829,0,0,0,324.99,
678958740202,74020,0,0,0,384.99,
678958744200,74420,33,0,33,359.99,
678958744217,74421,12,22,34,359.99,
678958744422,74442,0,0,0,384.99,
678958745207,74520,0,0,0,399.99,
678958799200,79920,0,0,0,389.99,
678958938203,93820,0,0,0,339.99,
678958123241,12324,0,0,0,304.99,
678958538106,53810,99,81,180,324.99,
678958538441,53844,32,21,53,314.99,
678958538458,53845,43,11,54,314.99,
678958635201,63520-CHT,0,0,0,379.99,
678958744293,74429,16,28,44,354.99,
705263141315,M-PM-45FS8,21,12,33,25.99,
705263141421,M-CL-45FS8,30,13,43,,
705263151505,M-PM-45FS10,22,41,63,27.99,
019962233005,M-RPM-45FS8,44,21,65,28.99,
019962233104,M-RPM-45FS10,40,28,68,30.99,
705263141209,M-MG-45CP7,25,23,48,23.99,
705263141100,M-MG-45FS8,48,22,70,23.99,
790072997659,M-RP-9FS10,30,20,50,,
810651029196,801-01008-00,3,2,5,1145.99,
810651029202,801-01009-00,0,2,2,1145.99,
810651029219,801-01010-00,12,4,16,1145.99,
810651029226,801-01011-00,1,1,2,1145.99,
810651029233,801-01012-00,7,5,12,1145.99,
810651029240,801-01013-00,1,2,3,1145.99,
810651029349,801-01015-00,2,1,3,1366.99,
810651029363,801-01016-00,3,1,4,1366.99,
810651029370,801-01018-00,2,3,5,1366.99,
810651029721,801-01021-00,2,2,4,1145.99,
810651029738,801-01022-00,0,2,2,1145.99,
696528086789,801-01023-00,3,4,7,1145.99,
696528086796,801-01024-00,1,4,5,1145.99,
696528087601,801-01026-00,3,1,4,1637.99,
696528087618,801-01027-00,2,1,3,1637.99,
691328238147,801-01072-00,5,7,12,1366.99,
691328238154,801-01073-00,3,7,10,1366.99,
691328238161,801-01074-00,1,5,6,1366.99,
691328238178,801-01075-00,4,5,9,1366.99,
691328238192,801-01077-00,2,1,3,1366.99,
691328238208,801-01078-00,3,4,7,1366.99,
691328238215,801-01079-00,4,3,7,1366.99,
691328238222,801-01080-00,4,3,7,1366.99,
691328238239,801-01081-00,2,5,7,1366.99,
691328238246,801-01082-00,2,2,4,1366.99,
691328238253,801-01083-00,0,1,1,1366.99,
691328238260,801-01084-00,5,7,12,1366.99,
691328238277,801-01085-00,3,8,11,1366.99,
691328238284,801-01086-00,2,0,2,1366.99,
691328238291,801-01087-00,6,5,11,1366.99,
691328238307,801-01088-00,4,0,4,1366.99,
691328238499,801-01107-00,1,2,3,1558.99,
691328238505,801-01108-00,2,2,4,1558.99,
691328238604,801-01118-00,3,1,4,1558.99,
840290520259,801-01190-00,0,0,0,1366.99,
840290520266,801-01191-00,0,2,2,1366.99,
840290520273,801-01192-00,0,0,0,1558.99,
840290520280,801-01193-00,1,0,1,1558.99,
840290520297,801-01194-00,0,0,0,1428.99,
840290520334,801-01198-00,0,0,0,2165.99,
810651029035,801-02001-00,1,3,4,1412.99,
810651029059,801-02003-00,3,0,3,1412.99,
810651029066,801-02004-00,2,0,2,1412.99,
810651029073,801-02005-00,0,1,1,1412.99,
810651029486,801-02006-00,4,2,6,1412.99,
810651029516,801-02009-00,4,2,6,1412.99,
810651029523,801-02010-00,4,1,5,1412.99,
810651029615,801-02011-00,1,0,1,1412.99,
810651029622,801-02012-00,2,1,3,1412.99,
696528086550,801-02014-00,1,5,6,1501.99,
696528086567,801-02015-00,3,9,12,1501.99,
696528086802,801-02016-00,0,1,1,1412.99,
696528086819,801-02017-00,2,2,4,1412.99,
840290520402,801-02018-00,0,0,0,1412.99,
840290520419,801-02019-00,0,3,3,1412.99,
810651029134,801-03001-00,3,1,4,2126.99,
810651029141,801-03001-01,1,5,6,2126.99,
810651029158,801-03001-02,4,0,4,2126.99,
810651029165,801-03002-00,4,0,4,2126.99,
810651029172,801-03002-01,13,10,23,2126.99,
810651029189,801-03002-02,2,3,5,2126.99,
810651029264,801-03003-00,0,3,3,2214.99,
696528087199,801-03005-01,2,0,2,2214.99,
810651029295,801-03006-00,5,2,7,2126.99,
696528086383,801-03008-00,6,2,8,2126.99,
696528086390,801-03008-01,1,1,2,2126.99,
696528086406,801-03008-02,7,2,9,2126.99,
696528086413,801-03009-00,10,1,11,2126.99,
696528086420,801-03009-01,8,1,9,2126.99,
696528086437,801-03009-02,7,4,11,2126.99,
696528086444,801-03010-00,1,4,5,2214.99,
696528087205,801-03012-01,0,0,0,2214.99,
696528086475,801-03013-00,3,2,5,2126.99,
696528086970,801-03017-00,2,0,2,2214.99,
696528086987,801-03018-00,1,5,6,2214.99,
840290520426,801-03105-00,0,0,0,2214.99,
840290520433,801-03106-00,1,1,2,2214.99,
840290520440,801-03107-00,2,0,2,2214.99,
696528087182,801-04003-00,1,0,1,2251.99,
696528086994,801-05002-00,0,1,1,3942.99,
810651025563,801-05003-00,1,0,1,3942.99,
810651029417,801-06001-00,1,1,2,1993.99,
810651029424,801-06003-00,1,1,2,1993.99,
810651029585,801-06005-00,3,2,5,1771.99,
810651029592,801-06015-00,1,1,2,1771.99,
810651029943,801-06020-00,3,0,3,1860.99,
810651029967,801-06021-00,3,1,4,1860.99,
696528086222,801-06028-00,2,0,2,1860.99,
696528086239,801-06029-00,3,4,7,1860.99,
696528086246,801-06030-00,3,4,7,1860.99,
696528086253,801-06030-01,2,4,6,1860.99,
696528086277,801-06032-00,1,1,2,1860.99,
696528086284,801-06033-00,3,2,5,1860.99,
696528086291,801-06034-00,3,3,6,1860.99,
696528086307,801-06035-00,0,0,0,1860.99,
696528086369,801-06039-01,1,0,1,2082.99,
810651029851,801-06042-01,9,2,11,1771.99,
696528086826,801-06051-00,0,3,3,1771.99,
696528086840,801-06053-00,1,3,4,1771.99,
696528086857,801-06054-00,2,3,5,1860.99,
696528087656,801-06071-00,5,1,6,2215.99,
696528088271,801-06080-00,1,2,3,1993.99,
691328238055,801-06120-00,2,4,6,1860.99,
691328238062,801-06121-00,2,3,5,1860.99,
691328238079,801-06122-00,4,0,4,1860.99,
691328238086,801-06123-00,2,1,3,1860.99,
696528090854,801-06133-00,7,7,14,2037.99,
696528090861,801-06134-00,2,3,5,2037.99,
696528090892,801-06135-00,0,1,1,2037.99,
696528090915,801-06137-00,3,3,6,2037.99,
696528090922,801-06138-00,2,0,2,2037.99,
696528090953,801-06141-00,1,1,2,2037.99,
696528090977,801-06143-00,2,7,9,2037.99,
696528090984,801-06144-00,2,1,3,2037.99,
696528090991,801-06145-00,6,3,9,2037.99,
696528091004,801-06146-00,0,2,2,2037.99,
696528091011,801-06147-00,1,4,5,2037.99,
696528091059,801-06151-00,1,1,2,2037.99,
696528091066,801-06152-00,1,1,2,2037.99,
696528091110,801-06155-00,16,8,24,2037.99,
696528091127,801-06156-00,1,1,2,2037.99,
696528091141,801-06157-00,3,3,6,2037.99,
696528091158,801-06158-00,2,5,7,2037.99,
696528091165,801-06159-00,4,1,5,2037.99,
696528091172,801-06160-00,5,3,8,2037.99,
696528091189,801-06161-00,2,2,4,2037.99,
696528091196,801-06162-00,0,1,1,2037.99,
696528091202,801-06163-00,1,2,3,2037.99,
696528091219,801-06164-00,2,1,3,2037.99,
696528091264,801-06170-00,1,5,6,2259.99,
696528091301,801-06172-00,0,1,1,2259.99,
696528091387,801-06180-00,2,0,2,2259.99,
696528091547,801-06189-00,6,3,9,2126.99,
696528091578,801-06191-00,8,1,9,2126.99,
696528091608,801-06194-00,1,3,4,2126.99,
696528091615,801-06195-00,3,3,6,2126.99,
696528091646,801-06198-00,1,2,3,2126.99,
696528091677,801-06200-00,3,2,5,2126.99,
696528091684,801-06201-00,0,2,2,2126.99,
696528091691,801-06202-00,1,3,4,2126.99,
696528091707,801-06203-00,0,3,3,2126.99,
696528091714,801-06204-00,2,3,5,2126.99,
696528091806,801-06212-00,3,0,3,2347.99,
696528092490,801-06275-00,13,12,25,2126.99,
696528092506,801-06276-00,2,1,3,2126.99,
696528092513,801-06277-00,10,2,12,2126.99,
696528092520,801-06278-00,1,4,5,2126.99,
696528092537,801-06279-00,2,1,3,2126.99,
696528092544,801-06280-00,2,3,5,2126.99,
696528092551,801-06281-00,2,4,6,2126.99,
840290520488,801-06318-00,0,3,3,2037.99,
840290520495,801-06319-00,0,6,6,2037.99,
840290520525,801-06321-00,0,0,0,2259.99,
840290520532,801-06322-00,0,0,0,2126.99,
840290520556,801-06324-00,0,0,0,2126.99,
840290520594,801-06328-00,1,3,4,2924.99,
810651029639,801-07001-00,1,1,2,2251.99,
696528086956,801-07002-00,0,0,0,2251.99,
696528087175,801-07003-00,1,2,3,2251.99,
840290520709,801-07006-00,0,0,0,2251.99,
840290520716,801-08009-00,0,0,0,4424.99,
696528087687,801-09003-00,0,1,1,1432.99,
696528087984,801-09003-01,0,1,1,1474.99,
696528087991,801-09003-02,0,0,0,1474.99,
696528087694,801-09004-00,2,2,4,1432.99,
696528088004,801-09004-01,2,0,2,1474.99,
696528088011,801-09004-02,1,2,3,1474.99,
696528089131,801-09005-00,0,0,0,1516.99,
696528089148,801-09005-01,0,3,3,1558.99,
696528089155,801-09005-02,1,1,2,1558.99,
696528086598,801-10003-00,0,1,1,2126.99,
696528086611,801-10004-00,1,0,1,2126.99,
696528086680,801-10011-00,0,1,1,2126.99,
696528086697,801-10012-00,3,0,3,2126.99,
696528086758,801-10017-00,1,2,3,2126.99,
696528086864,801-10020-00,0,0,0,2126.99,
840290520730,801-10034-00,4,4,8,2126.99,
696528087779,801-12001-00,0,0,0,725.99,
696528087786,801-12002-00,0,2,2,725.99,
691328238024,801-12006-00,0,0,0,813.99,
691328238031,801-12007-00,6,0,6,813.99,
696528095910,801-12012-00,0,0,0,857.99,
696528095927,801-12013-00,2,5,7,857.99,
696528095934,801-12014-00,6,0,6,857.99,
696528095958,801-12016-00,0,0,0,918.99,
696528095965,801-12017-00,0,0,0,918.99,
696528095972,801-12018-00,0,0,0,918.99,
696528095989,801-12019-00,0,0,0,918.99,
696528095941,801-12015-00,4,4,8,857.99,
840290501302,801-13001-00,0,0,0,2771.99,
840290501319,801-13002-00,0,2,2,2771.99,
840290501326,801-13003-00,1,2,3,2771.99,
840290501333,801-13004-00,2,2,4,2771.99,
840290501340,801-13005-00,1,0,1,2771.99,
840290501357,801-13006-00,1,1,2,2771.99,
840290501364,801-13007-00,0,0,0,2771.99,
840290501371,801-13008-00,1,1,2,2771.99,
840290501388,801-13009-00,0,0,0,2771.99,
810651023101,CA10154-1136435,0,0,0,2830.99,
810651023002,CA10154-1156435,0,0,0,2830.99,
810651023071,CA10154-3137235,0,0,0,2830.99,
810651023088,CA10154-3139236,0,0,0,2830.99,
810651022975,CA10154-3157235,0,0,0,2830.99,
810651022982,CA10154-3159236,0,0,0,2830.99,
810651024627,CA10266-275461,0,2,2,2251.99,
810651024559,CA10266-875361,0,0,0,2251.99,
810651024528,CA10266-H75261,3,1,4,2251.99,
810651025280,CA10268-215435,1,1,2,4424.99,
810651024825,CA10268-H14235,1,1,2,4424.99,
810651025648,CA10269-H14225,1,0,1,4424.99,
810651025471,CA10270-285481,1,4,5,2251.99,
810651025464,CA10270-482481,2,1,3,2251.99,
810651025457,CA10270-H85281,2,1,3,2251.99,
810651025525,CA10271-488481,2,2,4,2251.99,
810651025549,CA10272-482445,0,1,1,3719.99,
810651025532,CA10272-H85245,1,1,2,3942.99,
810651027017,CA10280-214411,5,4,9,1145.99,
810651027024,CA10280-314311,2,0,2,1145.99,
810651027031,CA10280-413411,7,7,14,1145.99,
810651028991,CA10280-815311,3,2,5,1145.99,
810651027055,CA10280-H13211,2,4,6,1145.99,
810651029004,CA10280-Y12711,5,0,5,1233.99,
810651027499,CA10290-112522,0,0,0,2033.99,
810651027505,CA10290-113522,1,2,3,2033.99,
810651027512,CA10290-115522,1,2,3,2033.99,
810651028168,CA10299-115411,0,0,0,1771.99,
810651028151,CA10299-215411,1,4,5,1771.99,
810651028519,CA10299-215413,1,1,2,1771.99,
810651028106,CA10299-315311,1,3,4,1771.99,
810651028465,CA10299-315313,2,6,8,1771.99,
810651028472,CA10299-414413,2,2,4,1771.99,
810651028144,CA10299-614411,1,5,6,1771.99,
810651028090,CA10299-815311,4,3,7,1771.99,
810651028458,CA10299-815313,1,1,2,1771.99,
810651028038,CA10299-915211,0,2,2,1771.99,
810651028052,CA10299-E14411,2,2,4,1771.99,
810651028021,CA10299-H14211,2,3,5,1771.99,
810651028380,CA10299-H14213,2,2,4,1771.99,
810651029103,CA10299-M15311,1,2,3,1771.99,
810651029127,CA10299-M15313,1,2,3,1771.99,
810651028137,CA10299-P15411,1,1,2,1771.99,
810651028496,CA10299-P15413,0,1,1,1771.99,
691328235221,810-00041-00,5,3,8,119.99,104.99
691328235238,810-00041-01,3,5,8,119.99,
691328235245,810-00041-02,2,0,2,119.99,
691328235252,810-00041-03,2,1,3,119.99,
691328235269,810-00041-04,1,2,3,119.99,
691328235283,810-00042-01,2,0,2,149.99,
691328235290,810-00042-02,2,2,4,149.99,
691328235306,810-00042-03,2,3,5,149.99,
691328235313,810-00042-04,2,4,6,149.99,
691328235337,810-00043-00,0,1,1,119.99,
691328235344,810-00043-01,2,1,3,119.99,
696528087670,801-06073-00,0,1,1,2215.99,
696528091592,801-06193-00,3,2,5,2126.99,
844234107339,ASPLINK-1,0,3,3,154.99,
814230101143,CA057,0,0,0,469.99,
814230011237,CA1000,0,0,0,499.99,
844234109944,CA151,0,0,0,499.99,
814230010339,CA340,0,0,0,499.99,
814230010353,CA346,0,0,0,499.99,
844234100040,CA346DOC,0,0,0,1289.99,
814230010360,CA347,0,0,0,499.99,
844234130276,CA362,0,0,0,599.99,
844234239382,CA363,0,0,0,599.99,
844234130443,CA4506DOCSET,0,0,0,1289.99,
814230010414,CA513M00,0,0,0,529.99,
844234101702,CA514M00,0,0,0,529.99,
814230011350,CA558,0,0,0,759.99,
814230011077,CA850,31,0,31,969.99,
844234239757,CA850N00,0,0,0,1059.99,
814230011084,CA855,0,0,0,969.99,
814230101150,CA8661,17,14,31,989.99,
814230101167,CA8662,0,0,0,989.99,
814230011114,CA9052,20,0,20,539.99,
814230101297,CA9052A00M19,0,0,0,779.99,
814230011480,CA9081,0,0,0,514.99,
844234107377,CA9081SSI01,0,0,0,724.99,
844234239559,CA9090,0,0,0,489.99,
844234102150,CA914,0,0,0,449.99,
814230011152,CA916,0,0,0,479.99,
814230011169,CA917,0,0,0,449.99,
814230011190,CA925,21,2,23,479.99,
814230010544,CA980,0,0,0,469.99,
814230010605,ER4100,0,0,0,674.99,
844234102501,ER4104,0,0,0,674.99,
844234128662,MP310GCI01BG,1,17,18,629.99,
814230010612,MP400,0,0,0,489.99,
844234239498,MP400B1401,0,0,0,439.99,
844234239528,MP400B1402,0,0,0,439.99,
814230010629,MP401,4,2,6,489.99,
814230010643,MP410,0,5,5,489.99,
844234239481,MP410B1401,0,0,0,439.99,
844234239511,MP410B1402,0,0,0,439.99,
844234128648,MP410SSI01,3,0,3,639.99,
814230010650,MP411,0,0,0,489.99,
844234128655,MP411SSI01,0,0,0,639.99,
814230010667,MP415,0,0,0,489.99,
844234127337,PP329,0,0,0,469.99,
844234127030,PP332,3,6,9,469.99,
844234127368,PP340,5,0,5,469.99,
814230101402,PP340MALO2,0,0,0,529.99,
844234128365,PP341,5,0,5,469.99,
844234127047,PP346,3,0,3,469.99,
814230101334,PP346MALO2,0,0,0,529.99,
844234127054,PP347,7,6,13,469.99,
814230010902,PP400,0,0,0,469.99,
844234240111,PP400LNI,0,0,0,634.99,
814230101358,PP400MALO2,0,0,0,529.99,
844234103133,PP401,0,0,0,469.99,
844234127856,PP405,0,0,0,469.99,
814230112213,PP410,0,0,0,469.99,
844234130290,PP410LNPT,3,0,3,689.99,
844234129898,PP410LNTXR,2,0,2,729.99,
844234129515,PP410LSFW,0,0,0,579.99,
814230101341,PP410MALO2,0,0,0,529.99,
844234103140,PP411,4,0,4,469.99,
844234130092,PP411LNBB,4,3,7,679.99,
844234128280,PP415,15,0,15,469.99,
844234129560,PP415LNI,0,0,0,634.99,
844234130009,PP415LNTRII,0,0,0,729.99,
844234127092,PP4500,0,0,0,639.99,
844234127115,PP4506,0,0,0,659.99,
844234127122,PP4507,0,0,0,659.99,
844234127351,PP4508,0,0,0,659.99,
844234128334,PP513M00,0,0,0,529.99,
844234128327,PP514M00,0,0,0,524.99,
844234127061,PP558,0,0,0,749.99,
844234129966,PPP22LR,0,0,0,369.99,
844234129942,PPP357,0,0,0,429.99,
844234129959,PPP357N,7,0,7,489.99,
844234129904,PPP45,0,0,0,429.99,
844234129935,PPP45N,0,0,0,489.99,
844234239764,PREACHER,0,0,0,479.99,
844234108954,RS410,0,0,0,759.99,
814230010001,AS100,0,0,0,1379.99,
814230101044,AS150,0,0,0,1199.99,
844234127016,AS188645-70R,0,0,0,1329.99,
844234103294,AS200,0,0,0,1489.99,
814230011381,AS530,0,0,0,1529.99,
814230015495,AS621,0,0,0,1119.99,
844234126699,CA2010G35,0,0,0,1189.99,
844234129140,CA2011G35,0,0,0,1189.99,
814230015419,CA2023,0,0,0,1229.99,
844234130283,CA2055AS1,0,0,0,1219.99,
844234239634,CA2057AS1,0,0,0,1219.99,
844234240173,CA2058AS1,0,0,0,1219.99,
814230010087,CA213,0,0,0,1229.99,
844234100842,CA233,0,0,0,1044.99,
844234100859,CA234,0,0,0,1069.99,
814230011275,CA270AS1,0,0,0,1169.99,
814230011282,CA271,0,0,0,1129.99,
814230010254,CA281,0,0,0,1129.99,
814230010261,CA282,0,0,0,1129.99,
814230010278,CA288,0,0,0,1259.99,
814230100900,CA2904,0,0,0,1139.99,
814230101419,CA2905B01,0,0,0,1079.99,
844234239573,CA2913,0,0,0,1199.99,
844234129737,SH771,0,0,0,1289.99,
844234240012,CA020C00LDAM,0,0,0,569.99,
844234240005,CA020C00LDWC,2,0,2,569.99,
844234240180,ONE-RANGER,0,12,12,574.99,
844234239344,AS188645-70PG,0,0,0,1599.99,
844234100613,CA219,0,0,0,1069.99,
844234104253,CA220AS1,0,0,0,1099.99,
844234100729,CA228AS1,0,0,0,1099.99,
844234106059,MP409,0,0,0,684.99,
844234126224,SH767,0,0,0,1999.99,
682146281811,CITC45FSPUSA,12,21,33,799.99,
682146281910,CITC45FSPUSG,14,1,15,799.99,
682146282146,CITC45FUSAAC,7,12,19,919.99,
682146832037,CIT17HMRBLT,0,0,0,153.0,
682146873627,CIT17HMRBLTFDE,0,0,0,153.0,
682146873634,CIT17HMRBLTODG,0,0,0,153.0,
682146830729,CIT22LRB,0,0,0,153.0,
682146873542,CIT22LRBFDE,0,0,0,153.0,
682146891225,CIT22LRBLT,0,0,0,153.0,
682146873573,CIT22LRBLTFDE,0,0,0,153.0,
682146873580,CIT22LRBLTODG,0,0,0,153.0,
682146873375,CIT22LRBLTUSA,12,27,39,219.99,
682146873559,CIT22LRBODG,0,0,0,153.0,
682146873382,CIT22LRBUSA,10,0,10,219.99,
682146832044,CIT22WMBLT,0,0,0,153.0,
682146873603,CIT22WMBLTFDE,0,0,0,153.0,
682146873610,CIT22WMBLTODG,0,0,0,153.0,
682146830743,CIT357LVR,0,0,0,689.99,
682146830750,CIT44LVR,0,0,0,689.99,
682146830767,CIT454LVR,0,0,0,799.99,
684168734740,CIT45LCLVR,0,0,0,689.99,
682146208207,BOSS-PT100,18,7,25,25.99,
682146280098,CIT45FSM,0,0,0,15.99,
682146280791,CIT9MMFSM,0,0,0,17.99,
682146891812,FRPPA122820WS,15,0,15,319.99,
810097507623,54AFCC8,10,0,10,,
816422027712,94AFC43,4,3,7,,
815835017150,22BA651,0,0,0,,
815835017143,22BA6AE,0,0,0,184.99,
815835011974,55AFF75,0,0,0,,
815835015408,55CA601,0,0,0,,
810097507630,54AFC44,38,33,71,,
,SBLKFS-XTNS,0,0,0,,
099654040920,952BLKCFDAGNS,0,0,0,,
099654041040,952BLKDAGNS,0,0,0,,
099654041019,952ORGDAGNS,0,0,0,,
099654036473,AFCCTLWDNS,0,0,0,,
099654036497,AFCCTLWTNS,0,0,0,,
099654041460,BAFRYK,0,0,0,,
099654026054,BCTLWDAGNS,0,0,0,,
099654026016,BCTLWDNS,0,0,0,,
099654026030,BCTLWTNS,0,0,0,,
099654042641,BLKCNCOTFPSWDNS,0,0,0,,
099654039634,BLKDIABLOAUTO,0,0,0,,
099654027389,BLKSFDNS,0,0,0,,
099654041132,BLKSTCM154DNS,0,0,0,,
099654038972,CALI928SBBLKDNS,0,0,0,,
099654038996,CALI928SBGRYDNS,0,0,0,,
099654038965,CALI928SBPURDNS,0,0,0,,
099654041224,CALI929TBBLKDNS,0,0,0,,
099654041231,CALI929TBBLUDNS,0,0,0,,
099654041248,CALI929TBGRYDNS,0,0,0,,
099654041026,CALI952BLKDNS,0,0,0,,
099654040968,CALI952PURDNS,0,0,0,,
099654041453,CCF777DNS,0,0,0,,
099654026177,CFCTLWDAGNS,0,0,0,,
099654026139,CFCTLWDNS,0,0,0,,
099654026153,CFCTLWTNS,0,0,0,,
099654042832,CTACEM390,0,0,0,,
099654042405,CTBDDNS,0,0,0,,
099654033489,CTBK-RH,0,0,0,,
099654042924,CTDOMBLK,0,0,0,,
099654038255,CTEBLKM390DNS,0,0,0,,
099654038934,CTEGRYM390DNS,0,0,0,,
099654042849,CTKPBLK,0,0,0,,
099654042856,CTKPODG,0,0,0,,
099654042467,CTRPTBLKDAGNS,0,0,0,,
099654042450,CTRPTBLKDNS,0,0,0,,
099654039061,GENTBLKCM154DNS,0,0,0,,
099654039078,GENTBLUCM154DNS,0,0,0,,
099654041118,GRYSTCM154DNS,0,0,0,,
099654024753,LBCTK-1LDNS,0,0,0,,
099654029017,LBFS-3DNS,0,0,0,,
099654029031,LBFS-3TNS,0,0,0,,
099654033106,LBLKFS-XDAGNS,0,0,0,,
099654033069,LBLKFS-XDNS,0,0,0,,
099654033083,LBLKFS-XTNS,0,0,0,,
099654033137,LBLUFS-XDNS,0,0,0,,
099654033151,LBLUFS-XTNS,0,0,0,,
099654031386,LBPUNFS-3DNS,0,0,0,,
099654041583,LBSWDNS,0,0,0,,
099654033205,LGYFS-XDNS,0,0,0,,
099654033229,LGYFS-XTNS,0,0,0,,
099654025033,LSWCTK-1LDNS,0,0,0,,
099654023329,MBCTK-1MDAGNS,0,0,0,,
099654023282,MBCTK-1MDNS,0,0,0,,
099654023305,MBCTK-1MTNS,0,0,0,,
099654035650,MBFS-3DNS,0,0,0,,
099654035674,MBFS-3TNS,0,0,0,,
099654032895,MBLKFS-XDAGNS,0,0,0,,
099654032857,MBLKFS-XDNS,0,0,0,,
099654032871,MBLKFS-XTNS,0,0,0,,
099654032925,MBLUFS-XDNS,0,0,0,,
099654032949,MBLUFS-XTNS,0,0,0,,
099654040500,MCATIFS-3DNS,0,0,0,,
099654040524,MCATIFS-3TNS,0,0,0,,
099654023374,MCFCTK-1MTNS,0,0,0,,
099654023350,MCFCTK-1MDNS,0,0,0,,
099654036008,MCFFS-3DNS,0,0,0,,
099654036022,MCFFS-3TNS,0,0,0,,
099654039702,MDTOMFS-3DNS,0,0,0,,
099654039726,MDTOMFS-3TNS,0,0,0,,
099654032994,MGYFS-XDNS,0,0,0,,
099654033014,MGYFS-XTNS,0,0,0,,
099654033496,MKBMDNS,0,0,0,,
099654033588,MKRMDNS,0,0,0,,
099654023565,MSWCTK-1MDNS,0,0,0,,
099654023602,MSWCTK-1MDAGNS,0,0,0,,
099654023589,MSWCTK-1MTNS,0,0,0,,
099654035797,MSWFS-3DNS,0,0,0,,
099654035810,MSWFS-3TNS,0,0,0,,
099654039795,MWTPFS-3DNS,0,0,0,,
099654039467,MURBCAMFS-3DNS,0,0,0,,
099654024470,MUSACTK-1MDNS,0,0,0,,
099654024494,MUSACTK-1MTNS,0,0,0,,
099654039818,MWTPFS-3TNS,0,0,0,,
099654026252,NYCTLWDNS,0,0,0,,
099654026313,ODCTLWDNS,0,0,0,,
099654041418,ODGAFRYK,0,0,0,,
099654042344,ODGDIABLOAUTO,0,0,0,,
099654021851,SBCTK-1SDAGNS,0,0,0,,
099654021813,SBCTK-1SDNS,0,0,0,,
099654021837,SBCTK-1STNS,0,0,0,,
099654031911,SBFS-3DAGNS,0,0,0,,
099654031874,SBFS-3DNS,0,0,0,,
099654031898,SBFS-3TNS,0,0,0,,
099654029581,SBLKFS-XDAGNS,0,0,0,,
099654029543,SBLKFS-XDNS,0,0,0,,
099654032611,SBLUFS-XDAGNS,0,0,0,,
099654032574,SBLUFS-XDNS,0,0,0,,
099654032598,SBLUFS-XTNS,0,0,0,,
099654029772,SBSWDNS,0,0,0,,
099654029796,SBSWTNS,0,0,0,,
099654041736,SCATIFS-3DNS,0,0,0,,
099654041750,SCATIFS-3TNS,0,0,0,,
099654041293,SCTEBLKM390DNS,0,0,0,,
099654041309,SCTEGRYM390DNS,0,0,0,,
099654041316,SCTERDM390DNS,0,0,0,,
099654041675,SDTOMFS-3DNS,0,0,0,,
099654041699,SDTOMFS-3TNS,0,0,0,,
099654032642,SGYFS-XDNS,0,0,0,,
099654032666,SGYFS-XTNS,0,0,0,,
099654038385,SILABADNS,0,0,0,,
099654022728,SPKCTK-1SDNS,0,0,0,,
099654022766,SPKCTK-1SDAGNS,0,0,0,,
099654032475,SPKFS-3DAGNS,0,0,0,,
099654032437,SPKFS-3DNS,0,0,0,,
099654022094,SSWCTK-1SDNS,0,0,0,,
099654022117,SSWCTK-1STNS,0,0,0,,
099654031942,SSWFS-3DNS,0,0,0,,
099654031966,SSWFS-3TNS,0,0,0,,
099654022834,STBCTK-1SDAGNS,0,0,0,,
099654022797,STBCTK-1SDNS,0,0,0,,
099654032505,STBFS-3DNS,0,0,0,,
099654023008,SUSACTK-1SDNS,0,0,0,,
099654023022,SUSACTK-1STNS,0,0,0,,
099654026238,SWCTLWDAGNS,0,0,0,,
099654026191,SWCTLWDNS,0,0,0,,
099654026214,SWCTLWTNS,0,0,0,,
099654041613,SWTPFS-3DNS,0,0,0,,
099654041637,SWTPFS-3TNS,0,0,0,,
099654041477,TANAFRYK,0,0,0,,
099654041170,TANDIABLOAUTO,0,0,0,,
099654026559,TBCTLWDNS,0,0,0,,
705442008132,CS-17T,41,43,84,,
705442019398,CS-20KJ,29,85,114,,
705442019060,CS-20KK,0,99,99,,
705442017752,CS-20NQL,9,43,52,,
705442017769,CS-20NQX,49,12,61,,
705442017783,CS-21ST,99,54,153,,
705442017653,CS-27BS,53,29,82,,
705442017622,CS-27BT,47,23,70,,
705442018513,CS-28DD,65,43,108,,
705442017936,CS-29AC,24,23,47,,
705442017943,CS-29AT,19,22,41,,
705442017974,CS-29AXT,36,13,49,,
705442018070,CS-35AE,0,0,0,,
705442018094,CS-35AN,59,16,75,,
705442016717,CS-39LSFC,17,9,26,,
705442016243,CS-49KST,21,26,47,,
705442017387,CS-49LCK,89,24,113,,
705442019282,CS-49LCKD,33,20,53,,
705442017394,CS-49LRT,86,9,95,,
705442018193,CS-58B,43,22,65,,
705442018216,CS-62JL,36,10,46,,
705442019572,CS-62K1,8,18,26,,
705442019428,CS-62RQ,25,6,31,,
705442014645,CS-80STK12Z,76,45,121,,
705442018971,CS-90AXF,21,28,49,,
705442007210,CS-90TA,88,11,99,,
705442013600,CS-90WVBA,0,29,29,,
705442000815,CS-92SF,59,61,120,,
705442010517,CS-95BUSK,0,3,3,,
705442005162,CS-97KMS,0,0,0,,
098289005397,ANACONDA-SP4RTS,0,0,0,1275.0,
098289005342,ANACONDA-SP6RTS,0,0,0,1275.0,
098289005359,ANACONDA-SP8RTS,0,0,0,1275.0,
098289007193,COBRA-SB2BB,0,0,0,593.0,
098289007148,COBRA-SS2BB,0,0,0,1103.0,
098289001290,KCOBRA-SB2BB,0,0,0,764.0,
098289001313,KCOBRA-SB2BB-S,0,0,0,764.0,
098289001283,KCOBRA-SB3BB,0,0,0,764.0,
098289001337,KCOBRA-SB4NS,0,0,0,849.0,
098289001306,KCOBRA-SB4TS,0,0,0,849.0,
098289001368,KCOBRA22-SP4RFO,0,0,0,849.0,
098289001351,KCOBRA22-SP6RFO,0,0,0,849.0,
098289111579,O1070BSTS,0,0,0,1275.0,
098289112316,O1070CCP-TT,0,0,0,1020.0,
098289111449,O1070CCS,0,0,0,851.0,
098289111593,O1070CCS-BT,0,0,0,851.0,
098289111890,O1070CE,0,0,0,1191.0,
098289111784,O1070CQB-FB,0,0,0,1870.0,
098289111791,O1070CS,0,0,0,1954.0,
098289042644,O1070M45,0,0,0,1447.0,
098289111456,O1072CCS,0,0,0,851.0,
098289111654,O1072CCS-BT,0,0,0,851.0,
098289111920,O1072CE,0,0,0,1191.0,
098289111463,O1073CCS,0,0,0,892.0,
098289111814,O1073CS,0,0,0,1997.0,
098289111609,O1080CCU,0,0,0,1274.0,
098289111852,O1080RGCCU,0,0,0,1359.0,
098289111616,O1082CCU,0,0,0,1274.0,
098289111869,O1082RGCCU,0,0,0,1359.0,
098289112187,O1911C,0,0,0,766.0,
098289112231,O1911C-38,0,0,0,807.0,
098289112408,O1911C-38DHM,0,0,0,1399.99,
098289112422,O1911C-RB,0,0,0,1275.0,
098289112224,O1911C-SS,0,0,0,851.0,
098289112248,O1911C-SS38,0,0,0,892.0,
098289112415,O1911C-SS38-DHM,0,0,0,1499.99,
098289111470,O1970CCS,0,0,0,807.0,
098289111388,O2020RG,0,0,0,1104.0,
098289111159,O2020XE,0,0,0,1020.0,
098289111524,O2020XE-TT,0,0,0,1020.0,
098289012197,O2071ELC2,0,0,0,1318.0,
098289111906,O4080CE,0,0,0,1191.0,
098289111937,O4082CE,0,0,0,1191.0,
098289111050,O4840XE,0,0,0,850.0,
098289111364,O4940XE,0,0,0,850.0,
098289111357,O4942XE,0,0,0,850.0,
098289111883,O5070GCL,0,0,0,1021.0,
098289111210,O5070XE,0,0,0,1447.0,
098289111975,O5072GCL,0,0,0,1021.0,
098289111227,O5072XE,0,0,0,1447.0,
098289111982,O5073GCL,0,0,0,1064.0,
098289112118,O5073XE,0,0,0,1489.0,
098289042927,O5870A1,0,0,0,1106.0,
098289111678,O5872A1,0,0,0,1106.0,
098289112255,O5873A1,0,0,0,1147.0,
098289113078,O5970GCL-TT,0,0,0,1064.0,
098289113085,O5970XE-TT,0,0,0,1489.0,
098289111203,O7000XE,0,0,0,849.0,
098289111913,O7080CE,0,0,0,1191.0,
098289111944,O7082CE,0,0,0,1191.0,
098289111180,O7800XE,0,0,0,849.0,
098289111197,O7802XE,0,0,0,849.0,
098289111876,O9840CCU,0,0,0,1274.0,
098289111968,O9842CCU,0,0,0,1274.0,
098289045256,P1640,0,0,0,1531.0,
098289045249,P1650,0,0,0,1531.0,
098289045614,P1670,0,0,0,1531.0,
098289009012,P1840,0,0,0,1531.0,
098289009036,P1850,0,0,0,1531.0,
098289009050,P1870,0,0,0,1531.0,
098289003355,PYTHON-SP3WTS,0,0,0,1275.0,
098289003287,PYTHON-SP4WTS,0,0,0,1275.0,
098289003270,PYTHON-SP6WTS,0,0,0,1275.0,
098289023292,AR15A4,29,0,29,935.0,
098289023285,AR6951,0,0,0,949.99,
098289047199,CBX-HV24CGA-308,0,0,0,1614.0,
098289047205,CBX-HV26CGA-65C,0,0,0,1614.0,
098289020673,CM556-16-M5S,9,5,14,1703.0,
098289116017,CR6762,0,0,0,1019.0,
098289023513,CR6920,1,4,5,934.0,
098289023643,CR6920-EPR,15,4,19,1190.0,
098289023537,CR6920MPS-B,35,1,36,1019.0,
098289023568,CR6940,0,0,0,1274.0,
098289023506,CR6960,25,7,32,1019.0,
098289020963,LE6920-FBP2,17,4,21,1445.0,
098289020604,LE6920-R,14,0,14,977.0,
098289019462,LE6920SOCOM,4,0,4,1276.0,
006285800007,SP62858,0,0,0,63.99,
098289900531,SP300100-RP,0,0,0,,
098289900548,SP300555-RP,0,0,0,,
982899005628,SP300733-RP,0,0,0,,
098289900579,SP300797-RP,0,0,0,,
098289900586,SP300808-RP,0,0,0,,
098289900241,SP53355B-RP,0,0,0,,
098289900258,SP54926B-RP,0,0,0,,
098289900265,SP55984B-RP,0,0,0,23.99,
098289900272,SP572491-RP,9,79,88,,
098289900302,SP573421-RP,0,0,0,,
098289900289,SP574001-RP,0,0,0,,
098289900593,SP574481-RP,0,0,0,,
098289900296,SP579991-RP,0,0,0,,
098289900357,SP62103-RP,0,0,0,,
098289900340,SP62328-RP,99,99,198,,
098289900609,SP945381-RP,0,0,0,,
098289112934,O1911C-TXR-200,0,0,0,,
098289112774,O1911C-38-ESB,0,0,0,,
850023124050,DAV-12405,0,0,0,1699.99,
850023124098,DAV-12409,0,0,0,1699.99,
850023124463,DAV-12446,0,0,0,1734.99,
850023124470,DAV-12447,0,0,0,1784.99,
850023124579,DAV-12457,0,0,0,1599.99,
850023124609,DAV-12460,0,0,0,1029.99,
098289041654,O1070A1CS,0,0,0,849.0,
098289112958,O1073BSTS-RG,0,0,0,1569.99,
098289112828,O1911C-38-JAL,0,0,0,,
,O1911C-38-TT,0,0,0,,
098289112392,O1911C-38AZT,0,0,0,1879.99,
,O1911C-38AZTS,0,0,0,,
098289112378,O1911C-SCB,0,0,0,1499.99,
098289112972,O1911C-SS-ERS,0,0,0,1999.99,
098289112385,O1911C-SS-SCS,0,0,0,1599.99,
098289112811,O1911C-SS-TT-E,0,0,0,799.99,
098289112736,O1911C-SS38-BDM,0,0,0,1999.99,
098289112699,O1911C-SS38-QTZ,0,0,0,1939.99,
,O1911C-SS38QTZE,0,0,0,,
098289112767,O1911C-USA,0,0,0,1329.0,
098289041487,O1980CGP,0,0,0,1104.0,
098289112064,O2991-TME,0,0,0,1589.0,
098289112170,O4042CS,0,0,0,2209.0,
098289111258,O4840CGP,0,0,0,1104.0,
098289009586,P1850-LDN,0,0,0,2999.99,
,P1850BPT,0,0,0,,
098289046154,P1850TLE,0,0,0,,
610242010110,CMR-301,0,0,0,165.48,
850002470123,CMR-301TAN,0,0,0,185.34,
850013143894,01-01720,0,0,0,99.3,
850013143771,01-01820,2,2,4,184.25,
610242001057,LG-105,0,1,1,164.87,
610242001118,LG-111,0,0,0,164.87,
610242000388,LG-431,1,1,2,164.87,
610242000586,LG-436,1,1,2,207.27,
610242000722,LG-375,0,0,0,233.17,
610242002955,LG-105-PINK,2,0,2,164.87,
610242004300,LG-489,1,2,3,164.87,
610242005222,CMR-204,16,9,25,295.58,
610242005239,CMR-205,6,0,6,210.8,
610242005598,LG-443,0,3,3,164.87,
610242005635,LG-489G,2,2,4,230.82,
610242006168,LG-350,1,5,6,233.17,
610242006182,LG-350G,0,0,0,304.99,
610242006144,CMR-206,0,0,0,164.87,
850002469356,CMR-209,0,0,0,54.16,
610242006151,LG-443G,3,0,3,230.82,
610242006656,LG-492G,2,0,2,230.82,
610242001088,LG-449,5,2,7,164.87,
610242004478,DS-121,0,0,0,80.57,
610242004485,DS-122,2,4,6,80.57,
610242004492,DS-123,0,0,0,80.57,
610242004508,DS-124,0,0,0,96.69,
610242005321,LG-639,1,0,1,182.53,
610242008186,LL-807,7,1,8,210.74,
610242008193,LL-807G,0,4,4,285.11,
610242001187,LG-492,1,1,2,164.87,
610242008599,LG-362,4,2,6,164.87,
610242009251,CMR-207G,0,0,0,143.22,
610242009268,CMR-207,0,0,0,107.11,
850002469257,LS-250,0,1,1,132.38,
610242009114,LG-416,0,0,0,164.87,
850002469400,LG-422,0,0,0,164.87,
850002469417,LG-422G,0,0,0,230.82,
610242009794,CWL-102,0,11,11,64.44,
610242002658,CMR-201,0,0,0,111.88,
850002469424,LG-459,0,0,0,164.87,
850002469431,LG-459G,0,1,1,230.82,
610242009121,LG-416G,8,3,11,230.82,
610242008469,LG-497,0,0,0,164.87,
610242008452,LG-497G,0,0,0,230.82,
850002469264,LS-250G,0,0,0,179.32,
810048570492,01-01080,0,1,1,528.0,
810048570478,01-01100,0,1,1,528.0,
810048570263,01-01180,1,1,2,365.53,
810048570300,01-01190,2,0,2,365.53,
810048570270,01-01220,2,1,3,162.44,
810048570287,01-01240,0,0,0,162.44,
810048570294,01-01250,3,1,4,203.05,
810048570195,01-01290,1,2,3,194.94,
810048570065,01-01340,0,1,1,487.39,
810048570072,01-01370,4,7,11,,
810048570225,01-01380,1,2,3,186.81,
810048570089,01-01390,0,5,5,227.43,184.99
810048570096,01-01400,1,0,1,268.05,
810048570362,01-01410,6,6,12,268.05,
810048570102,01-01420,0,1,1,308.66,
810048570119,01-01430,0,1,1,365.53,
810048570126,01-01440,3,1,4,146.19,
810048570232,01-01450,0,0,0,154.31,
810048570133,01-01460,0,0,0,162.44,
810048570140,01-01480,3,0,3,186.81,
810048570249,01-01490,0,0,0,178.69,
810048570157,01-01500,1,0,1,186.81,
810048570188,01-01530,0,1,1,227.43,
810048570201,01-01540,1,1,2,162.44,
810048570003,01-01550,14,41,55,105.57,
810048570010,01-01560,0,0,0,121.81,
810048570027,01-01570,0,0,0,129.94,
810048570034,01-01580,0,0,0,97.46,
810048570041,01-01590,0,0,0,121.81,
810048570164,01-01600,0,0,0,235.55,
810048570256,01-01680,0,1,1,162.44,
850013143818,01-01780,2,1,3,156.46,
850013143825,01-01800,0,0,0,136.0,
850013143856,01-01890,0,0,0,165.48,
850013143757,CTS-1550,0,0,0,104.25,
850013143665,01-01970,0,0,0,166.09,
850013143672,01-01980,0,3,3,235.88,
850013143740,CTS-25,0,0,0,54.98,
850013143993,01-3000000,2,1,3,308.66,
850013143955,01-3000018,0,1,1,145.02,
850013143979,01-3000038,0,0,0,175.11,
850013143931,01-02050,21,28,49,184.25,
850013143924,01-02060,29,23,52,138.18,
610242009800,CWL-202,4,14,18,71.89,
794023103205,1032-CRK,83,45,128,,
794023110517,1105K,7,10,17,,
794023201406,2014-CRK,21,5,26,,
794023208306,2083,8,5,13,,
794023213003,2130-CRK,29,12,41,,
794023226706,2267,58,19,77,,
794023236705,2367,17,12,29,,
794023237900,2379,17,10,27,,
794023238204,2382,10,3,13,,
794023238365,2383K,12,19,31,,
794023238402,2384K,42,41,83,,
794023238709,2387,21,14,35,,
794023238808,2388,43,26,69,,
794023238907,2389,21,17,38,,
794023239409,2394,43,32,75,,
794023239805,2398,18,8,26,,
794023239904,2399,42,16,58,,
794023242508,2425,22,19,41,,
794023248500,2485K,34,13,47,,
794023249002,2490KS,40,12,52,,
794023249309,2493,17,18,35,,
794023249507,2495K,27,20,47,,
794023252002,2520,9,17,26,,
794023252200,2522,44,17,61,,
794023263008,2630,24,11,35,,
794023270907,2709,28,10,38,,
794023272406,2724,27,14,41,,
794023273007,2730-CRK,24,17,41,,
794023273601,2736,12,11,23,,
794023273809,2738,33,13,46,,
794023275308,2753,32,14,46,,
794023286106,2861,21,16,37,,
794023286700,2867,44,24,68,,
794023290608,2906,26,15,41,,
794023290714,2907K,31,14,45,,
794023290806,2908,20,14,34,,
794023291704,2917,10,11,21,,
794023292701,2927,31,14,45,,
794023380101,3801-CRK,37,22,59,,
794023380200,3802K,45,36,81,,
794023381009,3810-CRK,47,32,79,,
794023403602,4036-CRK,30,16,46,,
794023403701,4037,11,8,19,,
794023404005,4040,45,35,80,,
794023404043,4040V,6,15,21,,
794023404104,4041B,0,0,0,,
794023404111,4041G,35,10,45,,
794023404128,4041O,33,0,33,,
794023404203,4042-CRK,50,9,59,,
794023404500,4045,80,17,97,,
794023405002,4050-CRK,18,17,35,,
794023531107,5311,23,12,35,,
794023531565,5315KS,50,19,69,,
794023531701,5317-CRK,20,20,40,,
794023531718,5317D2,23,12,35,,
794023532104,5321,44,19,63,,
794023538502,5385-CRK,10,5,15,,
794023541007,5410-CRK,9,6,15,,
794023547009,5470-CRK,57,13,70,,
794023572001,5720,39,18,57,,
794023613506,6135,7,5,12,,
794023627701,6277-CRK,33,15,48,,
794023629507,6295-CRK,49,20,69,,
794023645002,6450K,21,5,26,,
794023647006,6470-CRK,9,13,22,,
794023648003,6480,26,11,37,,
794023652505,6525,17,12,29,,
794023671001,6710,14,9,23,,
794023688009,6880-CRK,47,19,66,,
794023688504,6885,50,20,70,,
794023708103,7081,38,11,49,,
794023708301,7083,34,19,53,,
794023708608,7086,13,13,26,,
794023709506,7095,45,19,64,,
794023709605,7096,85,22,107,,
794023709704,7097,54,41,95,,
794023709759,7097K,49,24,73,,
794023712308,7123-CRK,29,6,35,,
794023719000,7190-CRK,24,11,35,,
794023727104,7271-CRK,23,16,39,,
794023747102,7471,47,25,72,,
794023752403,7524,24,15,39,,
794023792010,7920K,20,14,34,,
794023901108,9011,90,47,137,,
794023908206,9082,74,8,82,,
794023008241,K221KKP,24,19,43,,
794023002225,K230XXP,28,15,43,,
794023002232,K252GXP,19,4,23,,
794023936001,K360GXP,30,15,45,,
794023008258,K540GXP,39,15,54,,
794023920048,K920KKP,27,9,36,,
794023995374,K930RKP,39,19,58,,
794023090147,M16-01KS,33,26,59,,
794023090154,M16-01S,12,2,14,,
794023003505,M16-03BK,19,12,31,,
794023002171,M16-03DB,24,4,28,,
794023002188,M16-04DB,34,11,45,,
794023090178,M16-10KSF,37,19,56,,
794023131673,M16-14D,19,6,25,,
794023001839,M16-14DSFG,51,34,85,,
794023001822,M16-14SFG,50,15,65,,
794023141641,M16-14ZLEK,28,9,37,,
794023001853,M21-04G,31,19,50,,
794023211450,M21-14SF,32,11,43,,
794023040296,M4-02M,35,15,50,,
794023002140,M40-03,33,16,49,,
794023004441,R2201-90,0,0,0,,
,R2201-RMD,0,0,0,,
794023040203,M4-02,37,7,44,,
794023040210,M4-02S,33,12,45,,
806703011301,01130,0,2,2,549.99,
806703011523,01152,0,0,0,679.99,
806703011905,01190,0,5,5,549.99,
806703011943,01194,0,2,2,549.99,
806703011998,01199,0,0,0,549.99,549.99
806703015316,01531,7,0,7,334.99,
806703015606,01560,54,11,65,334.99,334.99
806703910864,91086,5,1,6,414.99,
806703911021,91102,5,4,9,549.99,
806703911304,91130,7,9,16,549.99,
806703911908,91190,19,36,55,549.99,
806703911946,91194,1,3,4,549.99,
806703911991,91199,0,0,0,549.99,
806703912202,91220,2,4,6,1359.99,
806703912226,91222,5,1,6,1359.99,
806703912493,91249,9,0,9,1699.99,
806703912516,91251,0,0,0,1079.99,
806703912578,91257,0,0,0,929.99,
806703912660,91266,0,0,0,1864.99,
806703915319,91531,21,0,21,334.99,
806703915401,91540,21,11,32,334.99,
806703915609,91560,99,96,195,334.99,
806703917320,91732,0,0,0,2299.99,
806703951805,95180,0,0,0,634.99,
806703951997,95199,8,0,8,254.99,
806703075037,07503,0,0,0,1109.99,
806703023014,02301,0,0,0,534.99,
806703023021,02302,16,16,32,534.99,
806703023106,02310,0,0,0,509.99,
806703023113,02311,0,0,0,509.99,
806703023120,02312,0,0,0,509.99,
806703023137,02313,25,19,44,469.99,
806703023144,02314,0,0,0,469.99,
806703023151,02315,0,0,0,469.99,
806703023656,02365,0,0,0,659.99,
806703023663,02366,0,0,0,664.99,
806703023700,02370,10,0,10,679.99,
806703023717,02371,0,0,0,704.99,
806703023724,02372,19,11,30,534.99,
806703023731,02373,0,0,0,679.99,
806703060927,06092,18,0,18,679.99,
806703060934,06093,7,3,10,679.99,
806703061306,06130,9,0,9,889.99,
806703061658,06165,8,9,17,489.99,
806703061672,06167,9,1,10,489.99,
806703061689,06168,9,8,17,579.99,
806703061702,06170,13,8,21,489.99,
806703063522,06352,11,9,20,634.99,
806703063904,06390,8,6,14,679.99,
806703063911,06391,7,1,8,679.99,
806703064017,06401,8,6,14,849.99,
806703064031,06403,1,3,4,849.99,
806703064130,06413,3,5,8,719.99,
806703064147,06414,3,12,15,719.99,
806703064178,06417,2,0,2,1019.99,
806703064628,06462,0,0,0,764.99,
806703064673,06467,9,4,13,764.99,
806703064710,06471,6,6,12,849.99,
806703064734,06473,6,7,13,849.99,
806703064833,06483,6,2,8,679.99,
806703064895,06489,2,4,6,719.99,
806703065403,06540,6,2,8,334.99,
806703065748,06574,11,0,11,509.99,
806703065786,06578,3,0,3,509.99,
806703073019,07301,0,0,0,849.99,
806703073026,07302,0,0,0,849.99,
806703073033,07303,0,0,0,849.99,
806703073040,07304,0,0,0,849.99,
806703074016,07401-CZU,0,0,0,634.99,
806703074023,07402-CZU,0,0,0,634.99,
806703074030,07403-CZU,0,0,0,634.99,
806703074047,07404-CZU,10,9,19,634.99,
806703074054,07405-CZU,0,0,0,634.99,
806703074061,07406,2,7,9,634.99,
806703074078,07407,9,6,15,634.99,
806703074085,07408,0,0,0,634.99,
806703074092,07409,12,0,12,634.99,
806703075044,07504,0,0,0,1109.99,
806703076010,07601,0,0,0,919.99,
806703076027,07602,0,0,0,919.99,
806703111018,11101,10,3,13,40.99,
806703111520,11152,2,2,4,40.99,
806703114019,11401,0,6,6,40.99,
806703114200,11420,49,7,56,30.99,
806703114231,11423,5,11,16,32.99,
806703114408,11440,15,3,18,30.99,
806703117522,11752,3,15,18,40.99,
806703120034,12003,20,0,20,25.99,
806703120041,12004,0,0,0,26.99,
806703120102,12010,15,5,20,25.99,
806703120201,12020,6,3,9,26.99,
806703130040,13004,6,0,6,37.99,
806703130071,13007,5,0,5,37.99,
806703013565,01356,37,4,41,1054.99,
806703815459,81545,0,9,9,559.99,
806703815619,81561,13,1,14,544.99,
806703891521,89152,8,0,8,809.99,
806703891538,89153,1,1,2,809.99,
806703895451,89545,2,18,20,559.99,
806703895611,89561,0,9,9,544.99,
806703895659,89565,1,5,6,544.99,
806703061825,06182,1,0,1,1434.99,
806703895437,89543,13,8,21,574.99,
806703914602,91460,0,0,0,1524.99,
806703914619,91461,0,0,0,1524.99,
806703021614,02161,0,0,0,509.99,
806703064185,06418,0,3,3,919.99,
1456321561208,FMD-2436,9,3,12,52.99,39.99
843102045919,FMD-2645,6,5,11,,
837058004496,WT-041,0,0,0,4.99,4.49
837058004519,WT-151,34,2,36,11.99,10.99
837058004625,WT-501,1,2,3,199.99,169.99
806703018232,01823,0,0,0,1959.99,
806703018249,01824,0,0,0,1669.99,
806703018256,01825,0,0,0,1669.99,
806703018263,01826,0,0,0,1959.99,
806703018843,01884,0,0,0,1479.99,
806703920016,92001,0,0,0,1789.99,
806703019376,01937,0,0,0,1974.99,
810042340008,GHOST45,0,0,0,,
810042340015,MASK22,0,0,0,,
810128161411,MOJAVE9,0,0,0,,
810128161473,MOJAVE9SIL,0,0,0,,
810042340039,NOMAD30,0,0,0,,
810042340169,NOMADL,0,0,0,,
810042342125,NOMADTI,0,0,0,,
810042340053,ODESSA-9,0,0,0,,
810042342316,PRIMAL,0,0,0,,
810042342637,SIERRA5KM,0,0,0,,
810042342323,SIERRA5XM,0,0,0,,
810042340060,SMK762,0,0,0,,
810042340077,SML762,0,0,0,,
810042340084,SMS762,0,0,0,,
810042340046,WOLFMAN,0,0,0,,
810042342828,WOLFMANKMQDK,0,0,0,,
810042340022,WOLVERINE,0,0,0,,
810042342118,DA5MDAS221,0,0,0,8.0,
810042342217,DA5MDAS301,0,0,0,,
810042340176,DA101,42,53,95,60.0,
810042340220,DA102,0,48,48,60.0,
810042340350,DA111,0,6,6,60.0,
810042342132,DA121,12,9,21,,
810042342149,DA122,10,7,17,60.0,
810042342156,DA123,0,13,13,60.0,
810042342163,DA124,0,12,12,60.0,
810042340558,DA206,38,11,49,59.0,
810042340596,DA301,0,0,0,60.0,
810042340626,DA302,0,28,28,60.0,
810042340787,DA401,2,0,2,55.0,
810042340886,DA405,0,0,0,55.0,
810042340909,DA406,0,0,0,55.0,
810042340954,DA409,0,5,5,24.0,
810042341074,DA419,3,0,3,25.0,
810042341098,DA420,4,2,6,25.0,
810042341111,DA421,8,4,12,,
810042341197,DA428,0,0,0,149.0,
810042341289,DA451,14,6,20,,
810042342170,DA455,0,0,0,89.0,
810042341425,DD111,8,6,14,55.0,
810042341449,DD440,1,1,2,55.0,
810042341463,DD441,1,0,1,55.0,
810042341692,WV201,9,1,10,55.0,
810042341715,WV202,14,11,25,99.0,
810042341784,WV205,2,4,6,55.0,
810042341807,WV206,1,4,5,55.0,
092187014932,01493,12,8,20,,
092187015236,01523-DEX,17,8,25,,
092187015434,01543-DEX,7,7,14,,
092187041334,04133,10,9,19,,
092187055331,05533,13,10,23,,
092187082535,08253,11,5,16,,
092187124433,12443-DEX,8,11,19,,
092187134531,13453,8,6,14,,
092187134630,13463,10,2,12,,
092187153037,15303,25,2,27,,
092187249006,24900,10,3,13,,
092187249013,24901-DEX,10,12,22,,
092187249020,24902,14,11,25,,
092187249037,24903-DEX,6,4,10,,
092187249044,24904,11,4,15,,
092187249075,24907,9,8,17,,
092187249105,24910-DEX,19,4,23,,
092187249112,24911,14,8,22,,
092187249129,24912,22,6,28,,
092187249136,24913,8,9,17,,
092187249143,24914-DEX,11,9,20,,
092187253539,25353,15,19,34,,
092187290039,29003,11,6,17,,
092187292439,29243,6,11,17,,
092187292736,29273,5,5,10,,
092187293139,29313,5,7,12,,
092187293535,29353-DEX,10,12,22,,
810035753334,DB0100E002,0,0,0,196.0,
810035753341,DB0100E022,0,0,0,206.0,
810035752542,DB0100E031,0,0,0,200.0,
810035753396,DB0100E032,0,0,0,200.0,
810035753365,DB0100E062,0,0,0,200.0,
810035753389,DB0100E072,0,0,0,200.0,
810035753358,DB0100E092,0,0,0,212.0,
810035753372,DB0100E112,0,0,0,200.0,
810035752566,DB0200P001,99,99,198,212.0,
810035752573,DB0200P021,65,73,138,223.0,223.0
810035752627,DB0200P031,64,21,85,215.0,
810035752597,DB0200P061,34,33,67,215.0,
810035752610,DB0200P071,26,56,82,215.0,
810035752580,DB0200P091,21,12,33,223.0,
810035752603,DB0200P101,0,3,3,215.0,
810035752658,DB0300P031,67,50,117,295.0,
810035752641,DB0300P061,7,6,13,295.0,
810035752450,DB0500A001,99,99,198,240.0,
810035755352,DB0500A051,0,10,10,240.0,
810035755369,DB0500A071,5,99,104,240.0,
810035755376,DB051CA001,0,0,0,197.0,
810035755086,DB0600A001,0,0,0,246.0,
810035752696,DB1614L001,6,0,6,939.0,
810035752702,DB1614L051,44,12,56,980.0,
810035755024,DB1614L071,6,23,29,980.0,
810035754713,DB1915K071,41,0,41,592.0,
810035755062,DB1921K001,0,0,0,810.0,
810035754638,DB1018C001,0,24,24,796.0,
810035754645,DB1018C061,42,46,88,840.0,
810035754652,DB1018C071,99,97,196,840.0,
810035754003,DB1032C001,99,26,125,977.0,
810035754010,DB1032C061,0,0,0,1026.0,
810035754027,DB1032C071,0,6,6,1026.0,
810035754034,DB1033M001,0,14,14,1111.0,
810035754041,DB1033M061,20,14,34,1160.0,
810035754058,DB1033M071,20,0,20,1160.0,
810035753006,DB1059C001,56,44,100,1248.0,
810035753013,DB1059C061,7,19,26,1290.0,
810035753020,DB1059C071,42,31,73,1290.0,
810035753037,DB1060M001,21,21,42,1383.0,
810035753044,DB1060M061,4,2,6,1427.0,
810035753051,DB1060M071,2,6,8,1427.0,
810035755499,DB106AC171,0,0,0,849.99,
810035755413,DB106AC181,53,13,66,849.99,
810035752733,DB1417P041,0,16,16,809.0,
810035752740,DB1417P071,12,12,24,809.0,
810035755536,DB1418P001,0,0,0,661.0,
810035754522,DB1717K001,31,0,31,538.0,
810035754508,DB1717K002,62,55,117,565.0,
810035754553,DB1717K003,99,99,198,549.0,
810035754560,DB1717K004,99,79,178,493.0,
810035755406,DB1717K005,0,0,0,431.0,
810035754515,DB1717K042,99,46,145,599.0,
810035754539,DB1717K061,51,35,86,587.0,
810035755390,DB1717K171,72,0,72,598.0,
810035754584,DB1718B001,50,37,87,549.0,
810035754591,DB1718B041,1,20,21,598.0,
810035754607,DB1718B061,0,0,0,598.0,
810035755529,DB1718O001,0,0,0,616.0,
810035755383,DB1718T001,0,0,0,559.0,
810035754614,DB1719B001,0,0,0,549.0,
810035754621,DB1719B061,64,31,95,598.0,
810035754577,DB1720H001,89,42,131,612.0,
810035755079,DB1721K001,0,0,0,801.0,
810035754096,DB1731K001,73,37,110,704.0,
810035754102,DB1731K061,10,0,10,747.0,
810035754119,DB1731K071,2,0,2,747.0,
810035755420,DB1731T001,0,0,0,772.0,
810035753136,DB1758K001,0,0,0,1001.0,
810035753143,DB1758K061,6,13,19,1043.0,
810035753150,DB1758K071,13,27,40,1043.0,
810035755482,DB176AK231,0,0,0,484.99,
810035754768,DB1790K001,7,89,96,587.0,
810035754744,DB1791K001,0,80,80,754.0,
810035754065,DB1836K001,0,0,0,754.0,
810035753105,DB1874K001,0,0,0,1118.0,
810035753112,DB1874K061,34,13,47,1167.0,
810035753129,DB1874K071,51,28,79,1167.0,
815875012023,DB380-MAGE,25,40,65,,
815875012337,DB9-MAGG4,75,0,75,18.99,
815875012313,DBAM29-MAG12R,10,0,10,19.99,
815875012320,DBAM29-MAG17R,10,0,10,21.99,
815875012375,DBX57-MAGFN,0,0,0,23.99,
810035755055,DB026AP141,99,99,198,219.99,
810035752634,DB0300P001,17,2,19,288.0,
810035754843,DB176AK011,69,0,69,549.99,474.99
810035755000,DB176AK141,99,99,198,549.99,
810035752863,DB176AK161,0,23,23,549.99,
810035752481,DB0100E001,41,30,71,196.0,
810035752511,DB0100E061,42,25,67,200.0,
810035752535,DB0100E071,31,0,31,200.0,
810035752504,DB0100E091,12,0,12,212.0,
810035752429,DB1911SS,0,0,0,2125.0,
810035752726,DB1417P001,68,34,102,778.0,
810035754126,DB1732N001,0,37,37,729.0,
689585855962,10500202,19,10,29,49.99,
689585854958,1910008,0,2,2,159.99,
689585854965,1910108,0,0,0,159.99,
689585854934,19200005,5,3,8,64.99,
689585854941,19200105,4,3,7,64.99,
689585854989,19300004,5,1,6,99.99,
689585854972,19300104,5,3,8,99.99,
689585854996,19200031,5,5,10,103.99,
689585855009,19200131,5,4,9,103.99,
689585854927,19400008,0,0,0,,
689585854910,19400108,0,0,0,,
689585854804,24000302,5,5,10,84.99,
689585854811,25000205,3,0,3,124.99,
689585854828,25003205,16,0,16,124.99,
689585854835,26000205,12,1,13,119.99,
689585854842,26003205,46,0,46,119.99,
689585854798,521411509,0,0,0,104.99,
687748696773,XX2T,0,0,0,,
850032424189,DP51655115486,0,0,0,659.99,
850032424158,DP51655109853,0,0,0,759.99,
850032424110,DP51655111539,0,0,0,699.99,
850032424165,DP51655114171,0,0,0,819.99,
741566904004,390034,8,10,18,597.0,
741566903816,390035,65,5,70,579.0,
741566903977,390036,2,1,3,579.0,
741566903137,390040,3,4,7,513.0,
741566903243,390044,0,0,0,529.0,
741566903267,390047,14,16,30,526.0,
741566903533,390053,0,2,2,554.0,
741566903151,390060,3,1,4,463.0,
741566903564,390061,10,6,16,535.0,
741566903588,390065,0,18,18,554.0,
741566903168,390070,3,0,3,463.0,
741566903502,390071,29,17,46,535.0,
741566903526,390073,0,2,2,554.0,
741566903540,390075,16,49,65,554.0,
741566905544,390078,48,62,110,489.99,
741566903175,390080,0,7,7,371.0,
741566903847,390081,14,0,14,449.0,
741566903373,390084,0,1,1,390.0,
741566903854,390085,30,0,30,467.0,
741566904073,390086,0,5,5,501.0,
741566904110,390088,0,0,0,627.0,
741566903342,390092,7,25,32,631.0,631.0
741566904585,390093,0,0,0,1027.0,
741566904431,390099,2,2,4,755.0,
741566905322,390106,18,25,43,374.99,354.99
741566905773,390440,0,0,0,431.0,
741566905254,390450,35,9,44,431.0,
741566905377,390455,83,0,83,449.0,
741566905384,390460,12,31,43,449.0,
741566905483,390465,0,29,29,532.0,
741566905490,390470,0,7,7,532.0,
741566905681,390488,0,0,0,792.0,
741566904196,390600,0,45,45,571.0,
741566905902,390608,0,0,0,549.99,
741566904202,390610,0,0,0,586.0,
741566903366,390082,0,0,0,390.0,
741566905308,391095,0,0,0,459.99,
741566905704,391495,1,0,1,649.99,
741566905353,392080,59,6,65,506.0,506.0
741566905360,392086,22,18,40,518.0,
741566905551,393060,99,99,198,399.99,359.99
741566905582,393064,99,69,168,449.99,379.99
741566905568,393070,99,99,198,399.99,
741566905575,393074,99,99,198,449.99,379.99
741566905506,393080,0,36,36,389.99,
741566905711,393085,19,14,33,469.99,
741566905698,393450,60,48,108,489.99,
741566905797,393453,57,0,57,554.99,
741566906176,395000,0,0,0,791.0,
741566906183,395010,0,0,0,791.0,
741566906220,395040,0,0,0,767.0,
741566906213,395050,0,0,0,767.0,
741566906244,395070,0,0,0,791.0,
741566903472,390145,0,0,0,332.0,
741566903489,390150,0,0,0,384.0,
741566905247,390153,0,0,0,497.0,
741566903793,390155,4,3,7,508.0,
741566903809,390160,0,24,24,508.0,
850020492671,111002,0,0,0,,
741566903748,390117,6,14,20,45.99,
741566905339,390076,59,64,123,484.99,
741566904080,390087,0,0,0,471.0,
741566103599,770125,0,0,0,299.0,
741566600678,770127,0,0,0,375.0,
741566600685,770128,0,0,0,389.0,
741566103605,770130,0,0,0,357.0,
741566103612,770133,0,0,0,335.0,
741566103339,770061,0,0,0,441.0,
0850016429018,PF-BACKPACK,6,10,16,234.99,
850016429124,PF-BACKPACK-FDE,98,2,100,234.99,
850016429087,PF-BAG,50,29,79,69.99,
850016429094,PF-BAG-BP,76,16,92,109.99,
850016429001,PF-LRT,33,26,59,525.0,454.99
850016429100,PF-LRT-FDE,99,99,198,525.0,
850016429117,PF-UBF,99,70,169,,
810083200378,FS380M,0,99,99,264.99,
741566906190,395020,0,0,0,767.0,
741566906206,395030,0,0,0,767.0,
845737015695,66-101386,0,0,0,849.0,
845737015688,66-101384,0,0,0,849.0,
845737013523,3868900751,0,0,0,987.0,
845737013530,3868900752,0,0,0,987.0,
845737013547,3868900753,0,0,0,987.0,
845737013554,3868900754,0,0,0,987.0,
845737003326,3868929302,0,0,0,1074.0,
845737003388,3868929352,0,0,0,1074.0,
845737008079,66-100002,0,4,4,539.0,
845737008086,66-100003,0,11,11,539.0,
845737013585,66-100256,0,0,0,1024.0,
845737009137,66-100373,0,0,0,794.0,
845737010119,66-100375,3,1,4,794.0,
845737009144,66-100383,2,0,2,794.0,
845737010010,66-100463,7,0,7,539.0,
845737010027,66-100464,3,0,3,539.0,
845737010232,66-100489,4,1,5,539.0,
845737010225,66-100490,9,5,14,539.0,
845737010195,66-100527,0,6,6,794.0,
845737010881,66-100571,1,2,3,624.0,
845737010898,66-100572,15,2,17,624.0,
845737010911,66-100574,24,24,48,624.0,624.0
845737010928,66-100575,11,16,27,624.0,
845737010737,66-100587,15,0,15,624.0,624.0
845737010744,66-100588,5,3,8,624.0,
845737011567,66-100741,2,5,7,624.0,
845737011574,66-100742,0,4,4,624.0,
845737011604,66-100745,24,6,30,794.0,
845737011611,66-100746,5,1,6,794.0,
845737012656,66-100780,3,0,3,794.0,
845737012137,66-100781,2,4,6,794.0,
845737012144,66-100782,3,1,4,794.0,
845737012151,66-100783,16,10,26,794.0,
845737012793,66-100815,2,2,4,539.0,
845737012809,66-100816,1,2,3,539.0,
845737012816,66-100818,8,0,8,539.0,539.0
845737012823,66-100819,0,6,6,539.0,
845737015169,66-100837,1,14,15,794.0,
845737015176,66-100838,8,4,12,794.0,
845737013141,66-100843,5,0,5,1204.0,
845737012359,66-100864,12,3,15,1109.0,
845737012366,66-100865,2,10,12,1109.0,
845737012373,66-100866,11,3,14,1109.0,
845737012380,66-100867,12,8,20,1109.0,
845737013158,66-100940,4,4,8,1204.0,
845737013332,66-101006,0,0,0,459.0,
845737013271,66-101009,0,0,0,459.0,
845737013295,66-101010,0,0,0,459.0,
845737013301,66-101011,0,0,0,459.0,
845737013592,66-101068,0,0,0,1109.0,
845737013608,66-101069,0,0,0,1024.0,
845737014391,66-101115,0,0,0,1024.0,
845737014384,66-101116,0,0,0,1109.0,
845737014377,66-101117,0,0,0,1024.0,
845737015046,66-101274,3,25,28,1074.0,
845737015145,66-101275,24,17,41,1074.0,1074.0
845737015053,66-101276,8,3,11,1074.0,
845737015138,66-101277,14,12,26,1074.0,
845737015411,66-101347,3,4,7,1204.0,
845737015428,66-101350,0,2,2,1204.0,
845737015596,66-101375,0,0,0,849.0,
845737015602,66-101376,0,0,0,849.0,
845737015589,66-101377,0,0,0,849.0,
845737015619,66-101378,0,0,0,849.0,
845737015664,66-101383,0,0,0,849.0,
845737015671,66-101385,0,0,0,849.0,
845737015879,66-101462,3,2,5,1204.0,
845737000103,66822,0,0,0,599.0,
845737001605,66836,2,0,2,599.0,
845737000851,66960,0,1,1,684.0,
845737000882,66961,5,3,8,684.0,
845737000875,66964,4,9,13,684.0,
845737000905,66965,3,7,10,684.0,
845737000912,66966,23,20,43,1024.0,
845737000981,66968,0,0,0,1024.0,
845737005399,66981,4,6,10,1024.0,
845737005405,66982,4,4,8,1024.0,
845737012885,36-100608,0,6,6,1204.0,
845737013103,36-100618,5,58,63,1089.0,1089.0
845737013721,36-100632,0,2,2,1404.0,
845737013738,36-100642,0,0,0,1469.0,
845737013745,36-100652,4,2,6,1469.0,
845737013714,36-100658,5,2,7,1319.0,
845737006211,36318,0,0,0,1594.0,
845737005061,36320,3,0,3,1594.0,
845737013677,38-100542-2,8,4,12,3894.0,
845737013684,38-100543-2,9,4,13,3894.0,
845737013691,38-100544-2,3,4,7,3894.0,
845737013707,38-100545-2,0,8,8,3894.0,
845737015220,38-101240,0,0,0,2839.0,
845737015237,38-101241,0,0,0,2839.0,
845737015244,38-101244,0,0,0,2839.0,
845737015251,38-101245,0,0,0,2839.0,
818513009201,3848950440,8,2,10,1614.0,
818513009218,3848950460,9,11,20,1614.0,
845737015077,46-100169,0,0,0,8329.0,
845737015091,46-100170,0,0,0,8329.0,
845737015084,46-100171,0,0,0,8769.0,
845737015107,46-100172,0,0,0,8769.0,
845737013561,98501-2,0,0,0,2934.0,
845737013622,98521-2,0,0,0,2934.0,
845737013578,98541-2,0,0,0,3264.0,
845737013653,98561-2,0,0,0,3264.0,
845737013615,98601-2,0,0,0,2934.0,
845737013639,98621-2,0,0,0,2934.0,
845737013646,98641-2,0,0,0,3264.0,
845737013660,98661-2,0,0,0,3264.0,
845737007768,20-100032-1,18,12,30,41.99,
845737007775,20-100032-2,13,8,21,41.99,
845737008413,20-100062,15,13,28,44.99,
845737009090,20-100261,0,39,39,35.0,
845737009106,20-100262,0,7,7,35.0,
845737010089,20-100346-1,12,24,36,41.99,
845737010096,20-100346-2,31,19,50,41.99,
845737010126,20-100348,42,19,61,41.99,
845737010386,20-100349,8,10,18,41.99,
845737010331,20-100375,18,11,29,41.99,
845737010348,20-100376,32,7,39,41.99,
845737010355,20-100377,18,6,24,41.99,
845737010362,20-100378,2,6,8,41.99,
845737010393,20-100379,26,18,44,41.99,
845737010409,20-100380,11,0,11,41.99,
845737013448,20-100502,24,15,39,28.99,
845737013455,20-100503,0,0,0,28.99,
845737014506,20-100568,54,30,84,44.99,
845737014131,20-100570,70,34,104,44.99,
845737014155,20-100572,0,0,0,44.99,
845737014179,20-100574,0,0,0,44.99,
845737015572,20-100681,0,0,0,35.0,
845737015459,20-100682,0,26,26,35.0,
845737016081,20-100719,0,0,0,42.0,
845737016111,20-100720,6,9,15,42.0,
845737016098,20-100732,0,0,0,53.0,
845737016104,20-100733,0,0,0,42.0,
845737016128,20-100734,0,0,0,53.0,
845737017026,20-100735,11,0,11,42.0,
818513001656,3810110093,0,30,30,36.0,
818513003582,3816101050,0,12,12,36.0,
818513003018,38661000300,0,21,21,35.0,
818513002523,3866100320,0,0,0,35.0,
845737000356,47694-2,34,25,59,44.99,
845737002541,66322-5,9,13,22,44.99,
845737002534,66322-6,9,48,57,44.99,
845737001162,66330-2,25,17,42,44.99,
818513009560,98880,24,0,24,27.0,
845737000554,98882,9,22,31,27.0,
845737000028,98890,38,48,86,44.99,
845737000035,98892,12,12,24,44.99,
845737016159,96-100717,0,0,0,,
845737016142,96-100718,0,0,0,,
845737016838,66-101632,0,0,0,1024.0,
845737016852,66-101634,0,0,0,1024.0,
845737016760,66-101641,0,0,0,539.0,
845737016784,66-101643,0,0,0,539.0,
845737016791,66-101649,0,9,9,,
845737016814,66-101651,0,13,13,794.0,
845737016883,66-101654,0,0,0,679.0,
845737016906,66-101660,0,0,0,679.0,
845737015329,38-101311,0,0,0,3849.99,
845737015299,38-101307,0,0,0,2889.99,
845737015305,38-101309,0,0,0,3189.99,
737214263043,456/2DOL,0,0,0,,
8053675007111,479,1,10,11,,
8053675904687,597,4,7,11,,
8053675010036,682,19,7,26,,
737214262688,FX-103MB,8,6,14,,
8053675017547,FX-133MGT,9,6,15,,
8053675913597,FX-273CF,14,3,17,,
8053675900269,FX-302ST,11,5,16,,
8053675912187,FX-523B,2,0,2,,
737214262534,FX-525B,0,0,0,,
8053675906209,FX-525DB,0,0,0,,
8053675911814,FX-526ALB,4,4,8,,
8053675911838,FX-526ALG,7,3,10,,
737214262428,FX-526CF,0,0,0,,
8053675915881,FX-526LEBR,7,0,7,,
8053675917861,FX-526LECOP,4,4,8,,
8053675914907,FX-526TCBL,4,0,4,,
737214262770,FX-527CF,0,0,0,,
8053675916055,FX-527TI,0,0,0,,
8053675916062,FX-527TIPVD,4,0,4,,
737214262497,FX-528,0,0,0,,
8053675907077,FX-528B,0,4,4,,
737214262862,FX-535BLB,12,5,17,,
8053675910954,FX-535OB,10,5,15,,
8053675912903,FX-536,10,20,30,,
8053675912880,FX-536CBB,2,7,9,,
737214262374,FX-550CFB,0,3,3,,
8053675916178,FX-550G10B,0,0,0,,
8053675916161,FX-550G10OD,3,1,4,,
8053675915065,FX-550TI,3,0,3,,
8053675915041,FX-550TIB,4,0,4,,
737214263081,FX-591,10,5,15,,
8053675910787,FX-598,11,7,18,,
8053675032373,FX-599,5,1,6,,
737214263104,FX-599TIC,6,5,11,,
8053675908135,FX-599TICS,8,4,12,,
8053675910909,FX-604,12,3,15,,
8053675915904,FX-608B,15,2,17,,
8053675915898,FX-608BL,5,5,10,,
8053675917823,FX-608CF,11,1,12,,
8053675917847,FX-608MC,9,9,18,,
8053675915911,FX-608OR,7,3,10,,
8053675915928,FX-608R,5,0,5,,
8053675917830,FX-608TI,7,4,11,,
737214262695,FX-609OD,20,5,25,,
8053675915201,FX-620B,10,8,18,,
8053675917724,FX-633,14,3,17,,
8053675917717,FX-633MOD,10,0,10,,
8053675917748,FX-634,17,3,20,,
8053675917755,FX-634MOD,13,8,21,,
8053675901570,FX-BR322,14,4,18,,
8053675032434,FX-MTF5,18,12,30,,
149780006328,FT0462,99,99,198,,
149780063604,FT0491,86,31,117,,
149780064069,FT0495,99,40,139,,
609224347603,12108-GEM,0,0,0,,
609224347610,12109,0,0,0,,
609728889609,12110,0,0,0,,
609224345906,12111,0,0,0,,
609224347849,12116,0,0,0,,
609224347856,12118,0,0,0,,
609224347627,12120,0,0,0,,
609224346989,12126,0,0,0,,
609728889661,12127,0,0,0,,
609728889692,12128,0,0,0,,
609224347832,12129,0,0,0,,
022188891898,13549,0,0,0,,
022188893779,13700-GEM,0,0,0,,
643477862759,GFMAG1012,13,1,14,29.99,
643477862742,GF5RND,0,0,0,28.99,
643477862780,GF11220B,0,0,0,199.99,
643477863237,GF11228WBNZ,0,0,0,239.99,
643477863244,GF11228WTG,0,0,0,239.99,
643477864333,GF12SXS20,0,0,0,639.99,
643477863107,GF25-USA,0,0,0,359.99,
643477863633,GF2P12L,0,0,0,199.99,
643477863640,GF2P12LFDE,13,0,13,209.99,
643477863657,GF2P12LODG,0,0,0,209.99,
643477863664,GF2P12LTG,0,0,0,209.99,
643477862902,GF2P2020,0,0,0,184.99,
,GF3P2020,0,0,0,,
643477862988,GF3PNW1220,0,0,0,249.99,
643477862995,GF3PNW2020,0,0,0,249.99,
643477862728,BR991220DLX,0,0,0,259.99,
643477863992,GFLVR20SKBB,1,0,1,669.99,
643477863954,GFLVR20SKFDE,2,1,3,669.99,
643477863930,GFLVR20SKSS,10,0,10,669.99,
643477863879,GFLVR20SKUSA,21,13,34,669.99,
643477863916,GFLVR20SS,0,0,0,499.99,
643477863893,GFLVR20SSTAC,6,4,10,559.99,
643477863909,GFLVR24SS,25,33,58,499.99,
643477863541,GFLVR410,26,17,43,524.99,
643477863510,GLVR410NKL,32,14,46,524.99,
643477863534,GFLVR410NKLS,0,10,10,524.99,
643477863558,GFLVR410S,22,7,29,524.99,
643477862926,GFP31220WNT,14,3,17,224.99,
643477863008,GFP32020WNT,0,0,0,224.99,
643477863015,GFP32028WNT,0,2,2,224.99,
643477862896,GFP3N1220,0,0,0,239.99,
643477862919,GFP312-3N1,16,99,115,289.99,199.99
643477863213,GFSB2022,0,0,0,104.99,
643477863220,GFSB41022,0,0,0,104.99,
643477864425,GFY1-RE,0,0,0,324.99,
643477863114,GFY1-USA,0,0,0,324.99,
643477864043,GFY1-USBNZ,0,0,0,324.99,
643477862773,GFY11220,0,23,23,299.99,
643477862872,GF251220,99,99,198,384.99,
643477862803,GF3T1220,0,0,0,144.99,
643477863978,GFLVR20SKSSFL,0,5,5,724.99,
643477864029,GFLVR24SKBEN,3,4,7,749.99,
643477864005,GFLVR24SKCAM,7,9,16,749.99,
643477863947,GFLVR24SKFDE,0,0,0,724.99,
643477863923,GFLVR24SKSS,8,12,20,724.99,
643477863862,GFLVR24SKUSA,9,3,12,749.99,
643477863886,GFLVR24SSTAC,0,0,0,559.99,
643477862933,GFP31228WNT,0,41,41,224.99,
643477861813,GF001220,99,15,114,384.99,274.99
643477862810,GF00S1220,99,99,198,384.99,
643477863794,GFLVR41CFDE,91,43,134,529.99,
643477863800,GFLVR41CFDES,58,54,112,529.99,
643477862940,GFP3W12-2N1,0,0,0,269.99,
643477862957,GFS161228,0,0,0,344.99,
643477862964,GFS162028,0,0,0,344.99,
643477862971,GFS1641028,0,0,0,344.99,
643477862858,GFY11220-FDE,32,0,32,334.99,
643477862865,GFY11220-TG,7,5,12,334.99,
850386008141,ACG-00814,52,7,59,419.99,399.99
850386008158,ACG-00815,99,99,198,459.99,439.99
850386008196,ACG-00819,5,18,23,419.99,399.99
850386008257,ACG-00825,99,29,128,459.99,439.99
850386008349,ACG-00834,14,26,40,419.99,399.99
850386008356,ACG-00835,99,44,143,459.99,439.99
850386008370,ACG-00837,24,11,35,419.99,399.99
850386008462,ACG-00846,36,0,36,419.99,399.99
850386008479,ACG-00847,51,22,73,459.99,439.99
850386008493,ACG-00849,16,14,30,419.99,399.99
850386008509,ACG-00850,22,11,33,459.99,439.99
850386008523,ACG-00852,41,6,47,419.99,399.99
850386008530,ACG-00853,59,9,68,459.99,439.99
850386008554,ACG-00855,21,4,25,419.99,399.99
850386008561,ACG-00856,48,0,48,459.99,
850386008585,ACG-00858,99,53,152,459.99,409.99
850386008615,ACG-00861,0,0,0,459.99,439.99
850386008622,ACG-00862,95,0,95,459.99,439.99
850386008639,ACG-00863,1,0,1,459.99,439.99
850386008646,ACG-00864,44,0,44,459.99,439.99
850386008653,ACG-00865,99,0,99,459.99,439.99
850386008660,ACG-00866,16,39,55,459.99,439.99
850386008691,ACG-00869,0,0,0,459.99,439.99
850386008707,ACG-00870,27,0,27,459.99,439.99
850016570048,ACG-57004,46,35,81,449.99,429.99
850016570055,ACG-57005,16,5,21,449.99,429.99
850016570109,ACG-57010,0,0,0,459.99,439.99
850016570130,ACG-57013,99,19,118,549.99,499.99
850016570147,ACG-57014,26,11,37,549.99,524.99
850016570154,ACG-57015,10,11,21,549.99,524.99
850016570178,ACG-57017,17,14,31,529.99,509.99
850016570185,ACG-57018,51,42,93,529.99,509.99
850016570208,ACG-57020,0,11,11,549.99,524.99
850016570215,ACG-57021,20,20,40,549.99,524.99
850016570222,ACG-57022,0,8,8,549.99,524.99
850016570239,ACG-57023,22,9,31,549.99,524.99
850016570246,ACG-57024,43,0,43,549.99,524.99
850016570253,ACG-57025,30,5,35,549.99,524.99
850016570260,ACG-57026,0,0,0,549.99,524.99
850016570277,ACG-57027,43,12,55,549.99,524.99
850016570284,ACG-57028,0,11,11,549.99,524.99
850016570314,ACG-57031,37,35,72,529.99,509.99
850016570321,ACG-57032,54,4,58,529.99,509.99
850016570338,ACG-57033,54,4,58,549.99,524.99
850016570345,ACG-57034,63,75,138,549.99,524.99
850016570369,ACG-57036,99,62,161,529.99,509.99
850016570468,ACG-57046,34,0,34,459.99,439.99
850016570475,ACG-57047,47,37,84,459.99,439.99
850016570482,ACG-57048,99,0,99,379.99,
850016570499,ACG-57049,99,0,99,379.99,
850016570536,ACG-57053,0,0,0,529.99,
850016570550,ACG-57055,61,32,93,419.99,399.99
850016570635,ACG-57063,35,0,35,459.99,439.99
850016570673,ACG-57067,99,0,99,549.99,524.99
850016570697,ACG-57069,0,0,0,489.99,484.99
850016570703,ACG-57070,0,0,0,489.99,484.99
850016570710,ACG-57071,0,4,4,479.99,469.99
850016570727,ACG-57072,3,0,3,459.99,439.99
850016570734,ACG-57073,58,36,94,529.99,509.99
850016570741,ACG-57074,30,0,30,529.99,509.99
850016570758,ACG-57075,50,19,69,549.99,524.99
850016570765,ACG-57076,0,0,0,479.99,469.99
850016570772,ACG-57077,0,3,3,479.99,469.99
850016570789,ACG-57078,0,0,0,479.99,469.99
850016570796,ACG-57079,2,49,51,549.99,524.99
850016570802,ACG-57080,99,75,174,549.99,524.99
764503043710,PA225S201MOS,70,49,119,546.0,546.0
764503037085,PA175S201,99,99,198,475.0,475.0
764503037108,PA175S203,0,9,9,475.0,475.0
764503037238,PA195S201,0,99,99,475.0,475.0
764503030819,PA195S201MOS,99,99,198,546.0,546.0
764503037252,PA195S203,2,0,2,475.0,475.0
764503030826,PA195S203MOS,0,0,0,546.0,546.0
764503054228,PA205S201MOS,0,0,0,546.0,546.0
764503054273,PA205S203MOS,0,0,0,546.0,546.0
764503054372,PA215S201MOS,0,0,0,546.0,546.0
764503054419,PA215S203MOS,0,0,0,546.0,546.0
764503043703,PA225S201,69,51,120,475.0,475.0
764503043727,PA225S203,99,90,189,475.0,475.0
764503043734,PA225S203MOS,99,45,144,546.0,546.0
764503043895,PA235S201,60,64,124,475.0,475.0
764503043901,PA235S201MOS,22,32,54,546.0,546.0
764503043918,PA235S203,0,0,0,475.0,475.0
764503043925,PA235S203MOS,0,0,0,546.0,546.0
764503044076,PA275S201,71,0,71,475.0,475.0
764503030017,PA343S101MOS,74,18,92,624.0,624.0
764503030024,PA343S103MOS,0,0,0,624.0,624.0
764503030918,PA455S201,99,48,147,475.0,475.0
764503034152,PA455S201MOS,35,99,134,546.0,546.0
764503030895,PA455S203,0,99,99,475.0,475.0
764503034183,PA455S203MOS,0,0,0,546.0,546.0
764503053597,PA475203MOS,0,0,0,546.0,546.0
764503053580,PA475S201MOS,0,0,0,546.0,546.0
764503032653,PA4850201,99,99,198,394.0,394.0
764503046636,PA4850201FRMOS,0,0,0,427.0,427.0
764503662010,PF20502-01,0,0,0,481.0,481.0
764503662034,PF20502-03,99,99,198,481.0,481.0
764503072017,PF-21502-01,99,99,198,481.0,481.0
764503072031,PF-21502-03,94,62,156,481.0,481.0
764503672019,PF29502-03,99,88,187,481.0,481.0
764503032011,PF3050201,99,99,198,481.0,481.0
764503802034,PG-20502-03,99,99,198,510.0,510.0
764503752018,PG-29502-01,99,96,195,510.0,510.0
764503762017,PG-30502-01,5,45,50,481.0,481.0
764503702013,PG-31502-01,0,0,0,440.0,440.0
764503016523,PG-31502-03,0,0,0,440.0,440.0
764503742019,PG-32502-01,0,0,0,440.0,440.0
764503742033,PG-32502-03,0,0,0,440.0,440.0
764503812019,PG-33502-01,0,0,0,440.0,440.0
764503682018,PG-37502,15,10,25,484.0,484.0
764503002656,PG40301-01-MOS,0,0,0,616.0,616.0
764503002670,PG40301-03-MOS,99,68,167,616.0,616.0
764503910722,PG-41301-01,99,62,161,525.0,525.0
764503910739,PG-41301-03,99,84,183,525.0,525.0
764503822018,PH3050201,99,50,149,481.0,481.0
764503175022,17002-10,99,99,198,440.0,440.0
764503502170,PI-17502-03,94,99,193,440.0,440.0
764503195020,19002-10,99,99,198,440.0,440.0
764503502194,PI-19502-03,66,43,109,440.0,440.0
764503225024,22002-10,99,99,198,440.0,440.0
764503502224,PI-22502-03,99,72,171,440.0,440.0
764503235023,23002-10,99,63,162,440.0,440.0
764503502231,PI-23502-03,18,14,32,440.0,440.0
764503265020,PI-26502,99,99,198,440.0,440.0
764503275029,PI-27502,0,0,0,440.0,440.0
764503315022,31502-2,7,0,7,440.0,440.0
764503335020,33502-0,0,0,0,440.0,440.0
764503343018,34301-8,20,0,20,525.0,525.0
764503301346,PI-34301-03,31,13,44,525.0,525.0
764503353017,PI-35301,18,0,18,525.0,525.0
764503301353,PI-35301-03,26,8,34,525.0,525.0
764503913884,PI-36502-01-FGR,52,12,64,481.0,481.0
764503375026,PI-37502,11,6,17,455.0,455.0
764503385025,PI-38502-01,0,2,2,455.0,455.0
764503395024,PI-39502-01,0,7,7,455.0,455.0
764503028816,PX1950701,95,16,111,518.0,518.0
764503026911,PX1950703,0,0,0,518.0,518.0
764503037894,PX4350201,0,0,0,394.0,394.0
764503046629,PX4350201FRMOS,0,0,0,427.0,427.0
764503037337,UA265S201,99,99,198,475.0,475.0
764503035920,UA4450101,99,99,198,316.0,316.0
764503049996,UA4850201FRMOS,0,0,0,427.0,427.0
764503913631,UG2150201,99,99,198,481.0,481.0
764503913648,UG2150203,0,0,0,481.0,481.0
764503913853,UG41301-01-MOS,99,81,180,587.0,587.0
764503913860,UG41301-03-MOS,20,64,84,587.0,587.0
764503048746,UI3430103,99,99,198,525.0,525.0
764503910616,UI-42502-01,99,0,99,351.0,351.0
764503913358,UI-43502-01,99,99,198,394.0,394.0
764503035883,33377,78,99,177,19.99,18.99
764503015595,33812,0,0,0,19.99,18.99
764503015656,33814,99,99,198,19.99,18.99
764503026683,47289,0,83,83,19.99,18.99
764503026690,47290,99,87,186,19.99,18.99
764503027345,47458,99,99,198,,
764503027352,47459,78,30,108,,
764503027369,47460,99,99,198,,
764503027376,47461,65,25,90,,
764503027383,47462,82,44,126,30.99,27.99
764503027390,47463,99,99,198,,
764503027857,47487,99,99,198,19.99,18.99
764503027864,47488,99,99,198,,
764503035876,47702,44,30,74,26.99,23.99
764503030765,47779,99,99,198,19.99,18.99
764503035890,47818,99,0,99,19.99,18.99
764503035913,47908,0,87,87,19.99,18.99
764503052163,65971,99,99,198,30.99,27.99
764503002854,MF00285,29,63,92,26.99,23.99
764503067815,MF06781,39,43,82,26.99,23.99
764503088209,MF08820,7,15,22,26.99,23.99
764503911576,MF08833,35,16,51,26.99,23.99
764503003950,MF08855,7,4,11,26.99,23.99
764503100178,MF10017,99,99,198,19.99,18.99
764503100192,MF10019,6,99,105,19.99,18.99
764503100208,MF10020,64,99,163,19.99,18.99
764503100215,MF10021,43,99,142,19.99,18.99
764503100222,MF10022,99,99,198,19.99,18.99
764503100239,MF10023,3,78,81,19.99,18.99
764503100314,MF10031,3,9,12,19.99,18.99
764503914225,MF17015B,0,0,0,19.99,
764503170171,MF17017,99,0,99,19.99,18.99
764503190155,MF19015,99,99,198,19.99,18.99
764503200151,MF20015,99,91,190,19.99,18.99
764503210136,MF21013,0,0,0,19.99,18.99
764503220159,MF22015,0,0,0,19.99,18.99
764503220227,MF22022,0,0,0,30.99,27.99
764503230134,MF23013,99,54,153,19.99,18.99
764503260100,MF26010,30,99,129,19.99,18.99
764503270093,MF27009,16,99,115,19.99,18.99
764503290107,MF29010,0,86,86,19.99,18.99
764503300103,MF30010,86,71,157,19.99,18.99
764503310157,MF31015,5,0,5,19.99,18.99
764503320132,MF32013,2,0,2,19.99,18.99
764503009273,MF33009,0,18,18,,
764503360060,MF36006,50,34,84,19.99,18.99
764503370106,MF37010,14,2,16,19.99,18.99
764503380082,MF38008,0,19,19,19.99,18.99
764503911118,MF42006,99,55,154,19.99,18.99
764503003967,MF43006,99,99,198,19.99,18.99
764503041983,50480,0,0,0,139.99,136.99
764503053856,70272,0,0,0,75.0,75.0
764503000607,AD00060,99,96,195,5.0,5.0
764503911613,AP60219,95,0,95,25.0,23.99
764503602146,AP60220,99,99,198,21.0,18.99
764503029035,AP60300,99,0,99,15.0,13.99
764503029042,AP60301,0,0,0,15.0,13.99
764503023521,AS02000,99,99,198,40.0,38.99
764503023538,AS02001,99,99,198,40.0,38.99
712456987167,AS10064,99,99,198,,
764503170706,ET17070,13,0,13,34.0,32.99
764503170430,17043-0,0,0,0,9.0,5.99
764503030802,03080-2,0,9,9,7.0,5.99
764503170768,17076-8,10,10,20,7.0,5.99
764503031663,TAC3166,23,11,34,75.0,64.99
764503172816,KB17281,0,0,0,24.0,22.99
764503007118,KD039179,0,3,3,24.0,22.99
764503007125,KG039180,99,99,198,24.0,22.99
764503007132,KF039181,99,22,121,24.0,22.99
764503912900,G304AUT,0,0,0,459.99,
,G43XAUT,0,0,0,,
850386008387,ACG-00838,99,0,99,459.99,409.99
850016570079,ACG-57007,29,6,35,459.99,439.99
850016570093,ACG-57009,70,0,70,459.99,409.99
850016570161,ACG-57016,76,27,103,549.99,
850016570192,ACG-57019,30,8,38,549.99,479.99
850016570352,ACG-57035,80,0,80,529.99,479.99
850016570574,ACG-57057,8,0,8,459.99,439.99
850016570581,ACG-57058,99,34,133,549.99,479.99
850016570598,ACG-57059,99,27,126,549.99,479.99
850016570604,ACG-57060,99,0,99,549.99,479.99
850016570628,ACG-57062,69,0,69,549.99,479.99
850016570666,ACG-57066,99,13,112,549.99,479.99
850016570680,ACG-57068,58,0,58,459.99,409.99
764503050350,G19X17AUT,0,0,0,504.99,
764503912955,G31415AUT,0,0,0,452.99,
764503037412,UA175S203,0,99,99,475.0,475.0
764503914683,UG4130103,60,0,60,561.0,561.0
764503001246,UI-26502-01,43,0,43,440.0,440.0
764503035944,PA173S302MOSAB,0,0,0,,
764503805028,PG20502,0,25,25,,
764503011016,PG20507,0,20,20,,
764503913778,UG2150202,0,17,17,,
764503913785,UG2150702,0,9,9,,
764503001109,UI1750202,0,42,42,,
764503175008,UI1750200,0,22,22,,
764503037092,PA175S202,0,36,36,,
764503037153,PA175S302AB,0,6,6,,
764503037191,PA175S702,0,22,22,,
764503037245,PA195S202,0,48,48,,
764503030437,PA195S202MOS,0,50,50,,
764503037283,PA195S302AB,0,10,10,,
764503029745,PA195S302MOSAB,0,32,32,,
764503037313,PA195S702,0,24,24,,
764503029721,PA195S702MOS,0,14,14,,
764503054266,PA205S202MOS,0,5,5,,
764503055225,PA205S302MOSAB,0,0,0,,
764503054358,PA205S702MOS,0,4,4,,
764503054402,PA215S202MOS,0,0,0,,
764503054471,PA215S302MOSAB,0,0,0,,
764503054518,PA215S702MOS,0,9,9,,
764503035685,PA225S202,0,1,1,,
764503039683,PA225S202MOS,0,0,0,,
764503043826,PA225S702,0,2,2,,
764503035692,PA235S202,0,9,9,,
764503039690,PA235S202MOS,0,7,7,,
764503044014,PA235S702,0,7,7,,
764503035708,PA275S202,0,5,5,,
764503044090,PA275S302AB,0,10,10,,
764503044113,PA275S702,0,14,14,,
764503029967,PA343S102MOS,0,0,0,,
764503030000,PA343S202MOS,0,1,1,,
764503029899,PA343S302MOSAB,0,11,11,,
764503029912,PA343S702MOS,0,9,9,,
764503029974,PA345S200MOS,0,13,13,,
764503029981,PA345S202MOS,0,2,2,,
764503029875,PA345S302MOSAB,0,9,9,,
764503029936,PA345S702MOS,0,22,22,,
764503030901,PA455S202,0,27,27,,
764503034411,PA455S202MOS,0,0,0,,
764503030970,PA455S302AB,0,22,22,,
764503034435,PA455S302MOSAB,0,0,0,,
764503030949,PA455S702,0,27,27,,
764503034428,PA455S702MOS,0,2,2,,
764503048487,PA475S202MOS,0,48,48,,
764503053641,PA475S302MOSAB,0,23,23,,
764503053634,PA475S702MOS,0,65,65,,
764503031755,PA4850202,0,27,27,,
764503046674,PA4850202FRMOS,0,34,34,,
764503032677,PA4850302AB,0,8,8,,
764503046698,PA4850302FRMOSA,0,55,55,,
764503032691,PA4850702,0,11,11,,
764503046681,PA4850702FRMOS,0,43,43,,
764503662027,PF2050202,0,9,9,,
764503072024,PF21502,0,12,12,,
764503014710,PF2150200,0,5,5,,
764503672026,PF2950202,0,9,9,,
764503027048,PF3050202,0,3,3,,
764503037023,PF3050702,0,5,5,,
764503755026,PG2950202,0,2,2,,
764503765025,PG30502,0,9,9,,
764503702020,PG3150202,0,8,8,,
764503815027,PG33502,0,2,2,,
764503914768,PG4050202MOS,0,1,1,,
764503910272,PG4150202,0,8,8,,
764503822025,PH30502,0,2,2,,
764503827020,PH30507,0,4,4,,
764503017391,PI1750200,0,49,49,,
764503017469,PI1950200,0,86,86,,
764503017582,PI2250200,0,1,1,,
764503008412,PI2350200,0,3,3,,
764503262029,PI26502,0,23,23,,
764503272028,PI27502,0,5,5,,
764503009419,PI31502,0,7,7,,
764503009563,PI32502,0,5,5,,
764503335020,PI33502,0,7,7,440.0,440.0
764503017902,PI3450200,0,10,10,,
764503355011,PI3550100,0,0,0,,
764503913891,PI3650202FGR,0,0,0,,
764503177002,PN1750700,0,10,10,,
764503197024,PN1950700,0,10,10,,
764503227028,PN22507,0,15,15,,
764503237003,PN2350700,0,7,7,,
764503009099,PN26507,0,9,9,,
764503009259,PN27507,0,11,11,,
764503027109,PX1950702,0,29,29,,
764503037900,PX4350202,0,91,91,,
764503046643,PX4350202FRMOS,0,49,49,,
764503037924,PX4350302AB,0,20,20,,
764503046667,PX4350302FRMOSA,1,67,68,,
764503037948,PX4350702,0,23,23,,
764503046650,PX4350702FRMOS,0,0,0,,
764503037344,UA265S202,0,8,8,,
764503037368,UA265S302AB,0,7,7,,
764503037382,UA265S702,0,10,10,,
764503005411,UG4150202MOS,0,5,5,,
764503910609,UI4250202,0,52,52,,
764503913365,UI4350202,0,18,18,,
764503913341,UI4350702,0,4,4,,
764503913112,G374AUT,2,0,2,474.99,
850023124067,DAV-12406,0,0,0,569.99,
850023124234,DAV-12423,0,0,0,499.99,
850023124418,DAV-12441,0,0,0,529.99,
0850023124548,DAV-12454,0,0,0,539.99,
196852132096,13209-TL,0,0,0,579.99,
196852158997,15899,0,0,0,519.99,
196852394746,39474,0,0,0,519.99,
196852805778,80577,0,0,0,579.99,
764503914430,G20415AUT,99,0,99,489.99,
764503032301,G294AUT,0,0,0,489.99,
764503053504,PA195S301UC,0,0,0,479.99,479.99
764503053511,PA195S301UCA,0,0,0,499.99,499.99
764503053535,PA195S303UCA,0,0,0,499.99,
764503053528,PA195S303UC,0,0,0,479.99,479.99
764503054075,PA453S3B7MOS6H2,0,0,0,949.99,949.99
764503053542,PA455S301UC,0,0,0,479.99,479.99
764503053832,PA455S301UCA,6,13,19,499.99,499.99
764503053559,PA455S303UC,99,99,198,479.99,479.99
764503053849,PA455S303UCA,99,75,174,499.99,499.99
764503572173,PI-17572-03,99,99,198,440.0,440.0
764503572197,PI-19572-03,0,77,77,440.0,440.0
764503225727,PI2257201,99,99,198,440.0,440.0
764503572227,PI-22572-03,99,99,198,440.0,440.0
764503235726,PI2357201,99,79,178,440.0,440.0
764503572234,PI-23572-03,99,99,198,440.0,440.0
764503275722,PI-27572,0,26,26,440.0,440.0
764503020490,PI4357201,36,99,135,394.0,394.0
764503053566,PX4350301UC,55,99,154,449.99,449.99
764503051319,UA4450301AOTB,0,20,20,419.99,419.99
764503914362,UG1759201,0,11,11,459.99,459.99
764503914515,UG1759203,0,80,80,459.99,459.99
764503914522,UG1959201,0,0,0,459.99,459.99
764503914539,UG1959203,0,0,0,459.99,459.99
764503051326,UX4350201FRMOSC,0,0,0,629.99,629.99
946845645825,2919,0,0,0,,
,USD-GLK-22-2-N,0,0,0,,
850040234022,GSGMGLK17,0,0,0,75.0,
850040234039,GSGMGLK19,0,0,0,75.0,
850040234008,GSMSGLK17,0,0,0,60.0,
850040234015,GSMSGLK19,0,0,0,60.0,
642230261341,81000018,5,2,7,629.0,
642230261358,81000019,0,3,3,699.0,
642230261372,81000020,0,0,0,629.0,
642230261389,81000021,3,0,3,699.0,
642230261365,81000022,0,0,0,759.0,
642230261273,81000026,16,13,29,629.0,
642230261280,81000027,0,0,0,699.0,
642230261310,81000030,0,0,0,759.0,
642230261334,81000032,0,0,0,759.0,
642230261129,81000039,6,3,9,679.0,
642230261143,81000040,3,0,3,769.0,
642230261570,81000041,2,2,4,679.0,
642230261150,81000043,0,0,0,679.0,
642230261174,81000044,2,0,2,769.0,
642230261440,81000045,0,0,0,679.0,
642230260788,81000047,4,1,5,679.0,
642230260801,81000048,3,0,3,769.0,
642230261457,81000049,4,5,9,679.0,
642230260818,81000051,1,1,2,679.0,
642230260832,81000052,4,0,4,769.0,
642230261181,81000053,2,0,2,679.0,
642230261198,81000054,8,0,8,769.0,
642230261204,81000055,2,0,2,679.0,
642230261211,81000056,4,1,5,769.0,
642230260849,81000057,14,0,14,679.0,
642230260856,81000058,0,0,0,769.0,
642230260863,81000059,2,0,2,679.0,
642230260870,81000060,1,1,2,769.0,
642230258198,81000061,0,0,0,679.0,
642230258211,81000062,0,0,0,769.99,
642230258181,81000063,0,0,0,679.0,
642230258204,81000064,0,0,0,769.99,
642230261587,81000078,0,0,0,2039.0,
642230261228,81000080,0,0,0,2039.0,
642230253353,81000084,3,1,4,629.0,
642230253414,81000085,5,1,6,709.0,
642230261877,81000086,0,1,1,629.0,
642230253445,81000087,1,2,3,709.0,
642230261839,81000088,0,0,0,629.0,
642230261846,81000089,9,4,13,709.0,
642230260337,81000093,0,0,0,629.0,
642230260344,81000094,0,0,0,709.0,
642230257146,81000095,4,9,13,629.0,
642230257153,81000096,4,3,7,709.0,
642230260467,81000103,10,0,10,629.0,
642230260481,81000104,2,0,2,709.0,
642230260474,81000105,4,0,4,629.0,
642230260498,81000106,8,5,13,709.0,
642230260504,81000107,0,0,0,629.0,
642230260528,81000108,12,8,20,709.0,
642230260511,81000109,13,3,16,629.0,
642230260535,81000110,5,7,12,709.0,
642230260542,81000111,46,40,86,629.0,
642230260566,81000112,7,8,15,709.0,
642230260559,81000113,1,0,1,629.0,
642230260573,81000114,15,0,15,709.0,
642230260580,81000115,0,0,0,629.0,
642230260603,81000116,0,0,0,709.0,
642230260597,81000117,0,0,0,629.0,
642230259706,81000118,3,5,8,709.0,
642230260610,81000119,0,0,0,629.0,
642230260634,81000120,11,6,17,709.0,
642230260627,81000121,2,0,2,629.0,
642230259713,81000122,2,0,2,709.0,
642230260641,81000123,2,1,3,629.0,
642230260665,81000124,1,3,4,709.0,
642230260658,81000125,2,2,4,629.0,
642230259720,81000126,2,6,8,709.0,
642230261600,81000127,0,0,0,629.0,
642230261594,81000131,0,0,0,629.0,
642230260184,81000223,0,25,25,629.0,
642230260191,81000224,35,26,61,709.0,
642230261952,81000225,4,3,7,629.0,
642230261969,81000226,5,4,9,709.0,
642230261976,81000227,21,9,30,629.0,
642230261983,81000228,2,3,5,709.0,
642230261990,81000229,13,9,22,629.0,
642230262003,81000230,13,10,23,709.0,
642230262010,81000231,2,5,7,629.0,
642230262027,81000232,0,0,0,709.0,
642230262034,81000233,7,7,14,629.0,
642230262041,81000234,3,6,9,709.0,
642230262058,81000235,2,5,7,629.0,
642230262065,81000236,4,3,7,709.0,
642230260405,81000241,0,0,0,629.0,
642230261853,81000242,0,0,0,709.0,
642230260375,81000243,2,3,5,629.0,
642230261860,81000244,2,1,3,709.0,
642230258778,81000263,0,0,0,629.0,
642230258785,81000264,1,0,1,709.0,
642230260085,81000269,3,2,5,629.0,
642230260092,81000270,4,2,6,709.0,
642230260108,81000271,2,0,2,629.0,
642230260115,81000272,4,4,8,709.0,
642230260207,81000283,43,27,70,629.0,
642230260214,81000284,99,92,191,709.0,
642230261891,81000285,0,10,10,629.0,
642230261907,81000286,24,19,43,709.0,
642230260061,81000288,0,3,3,679.0,
642230260078,81000289,0,8,8,769.0,769.0
642230260306,81000295,0,0,0,629.0,
642230260320,81000296,0,0,0,709.0,
642230261495,81000307,0,0,0,859.0,
642230260993,81000309,3,5,8,859.0,
642230261013,81000310,1,0,1,969.0,
642230261402,81000314,0,0,0,859.0,
642230260689,81000316,0,0,0,859.0,
642230260702,81000317,0,0,0,969.0,
642230261464,81000322,28,12,40,899.0,
642230260887,81000324,17,5,22,899.0,
642230260900,81000325,2,3,5,989.0,
642230261525,81000329,0,0,0,899.0,
642230261068,81000331,0,0,0,899.0,
642230261082,81000332,2,17,19,989.0,
642230261426,81000336,3,2,5,899.0,
642230260733,81000338,8,0,8,899.0,
642230260757,81000339,0,5,5,989.0,
642230260955,81000343,0,2,2,939.0,
642230260962,81000344,0,0,0,1019.0,
642230261501,81000347,0,0,0,1209.0,
642230261037,81000348,0,0,0,1289.0,
642230261471,81000350,0,0,0,1209.0,
642230260924,81000351,0,0,0,1289.0,
642230261549,81000361,0,0,0,1249.0,
642230261556,81000363,0,0,0,1349.0,
642230260412,81000364,0,0,0,939.0,
642230261716,81000365,0,0,0,939.0,
642230260429,81000367,0,0,0,939.0,
642230260399,81000368,0,0,0,939.0,
642230257894,81000403,0,0,0,419.0,
642230257900,81000404,0,0,0,419.0,
642230262096,81000470,0,0,0,419.0,
642230259959,81000483,0,0,0,679.0,
642230259966,81000484,0,0,0,749.0,
642230259973,81000485,0,1,1,679.0,
642230259980,81000486,0,0,0,749.0,
642230262997,81000553,5,14,19,859.0,
642230263000,81000554,4,1,5,859.0,
642230263017,81000555,0,0,0,859.0,
642230262119,81000591,0,0,0,729.0,
642230262126,81000592,0,0,0,829.0,
642230262133,81000593,2,1,3,729.0,
642230262140,81000594,0,0,0,829.0,
642230262485,81000625,0,0,0,849.0,
642230262492,81000626,20,5,25,849.0,
642230263338,81000732,4,12,16,679.0,
642230263345,81000733,10,1,11,749.0,
642230265417,81000806,0,0,0,629.0,
642230265424,81000807,0,0,0,709.0,
642230265455,81000810,0,0,0,679.0,
642230265479,81000812,1,3,4,629.0,
642230265509,81000815,4,2,6,709.0,
642230265516,81000816,8,0,8,629.0,
642230265523,81000817,6,1,7,709.0,
642230265530,81000818,20,0,20,709.0,
642230265547,81000819,8,0,8,629.0,
642230265561,81000821,16,10,26,629.0,
642230265578,81000822,18,4,22,709.0,
642230265585,81000823,19,10,29,629.0,
642230265592,81000824,19,9,28,709.0,
642230265608,81000825,0,0,0,629.0,
642230265615,81000826,6,9,15,709.0,
642230266117,81000841,0,0,0,989.99,
642230266131,81000843,0,0,0,989.99,
642230260382,81000092,0,0,0,1299.99,
642230257870,81000401,50,25,75,429.99,
642230257054,81000402,0,0,0,429.99,
642230258464,81000445,0,0,0,1339.99,
642230262072,81000468,0,0,0,429.99,
642230262089,81000469,0,0,0,429.99,
642230261655,81000498,0,0,0,6019.99,
642230262553,81000579,0,0,0,2719.99,
642230262560,81000580,0,0,0,2719.99,
642230262577,81000582,0,0,0,2719.99,
642230262584,81000586,0,0,0,3419.99,
642230262591,81000587,0,0,0,3419.99,
642230263963,81000751,0,0,0,1369.99,
642230254336,206349S,0,0,0,63.99,
642230243958,207339,9,2,11,34.99,
642230243965,214097,5,2,7,34.99,
642230243972,214305,0,1,1,34.99,
642230244092,215957,0,0,0,34.99,
642230247277,215979S,5,8,13,34.99,
642230247284,217439,2,0,2,34.99,
642230244269,227710S,0,5,5,34.99,
642230244320,234269,0,0,0,34.99,
642230256743,50239330,0,0,0,48.99,
642230262850,50255803,4,48,52,34.99,
642230265639,50257859,0,0,0,34.99,
642230265646,50257860,0,0,0,34.99,
642230257924,51000200,5,9,14,24.99,
642230262546,51001080,0,0,0,289.0,
642230262478,51001081,0,0,0,309.0,
642230260016,50254262,0,0,0,36.0,
642230261778,81000544,14,9,23,709.99,
642230261785,81000546,0,16,16,709.99,
642230263888,81000782,0,0,0,639.99,
642230259829,81000477,0,0,0,2629.99,
619835044051,H004MD3,0,0,0,,
619835011039,H001ML,0,0,0,389.99,
619835011077,H001MML,0,0,0,404.99,
619835060136,H006CML,0,0,0,874.99,
619835060143,H006ML,0,0,0,874.99,
619835060150,H006MML,0,0,0,874.99,
619835001009,H001,0,0,0,309.99,
619835011213,H001GG,0,0,0,359.99,
619835004000,H001L,0,0,0,334.99,
619835007001,H001M,0,0,0,444.99,
619835001030,H001ME,0,0,0,499.99,
619835007018,H001MLL,0,0,0,459.99,
619835011008,H001T,0,0,0,404.99,
619835011169,H001TLB,0,0,0,424.99,
619835011084,H001TLP,0,0,0,444.99,
619835010001,H001TM,0,0,0,484.99,
619835011176,H001TMLB,0,0,0,504.99,
619835011091,H001TMLP,0,0,0,524.99,
619835011121,H001TMRP,0,0,0,524.99,
619835011190,H001TMSPR,0,0,0,529.99,
619835011114,H001TRP,0,0,0,444.99,
619835011206,H001TSPR,0,0,0,444.99,
619835011015,H001TV,0,0,0,484.99,
619835017000,H001V,0,0,0,484.99,
619835003003,H001Y,0,0,0,319.99,
619835002006,H002B,0,0,0,254.99,
619835002037,H002BSGB,29,18,47,464.99,
619835008008,H002C,99,49,148,314.99,
619835002013,H002VWP,78,31,109,314.99,284.99
619835012012,H003T,0,0,0,484.99,
619835012005,H003TM,0,0,0,524.99,
619835006004,H004,0,0,0,474.99,
619835016263,H004AB,0,0,0,799.99,
619835016249,H004AE,0,0,0,819.99,
619835016188,H004AF,0,0,0,899.99,
619835016096,H004ES,0,0,0,934.99,
619835016171,H004FM,0,0,0,899.99,
619835016577,H004GBA,0,0,0,1029.99,
619835016331,H004GE,0,0,0,764.99,
619835016119,H004LE,0,0,0,899.99,
619835016003,H004M,0,0,0,529.99,
619835016379,H004MAS,0,0,0,899.99,
619835016423,H004MS2,0,0,0,1029.99,
619835016164,H004S,0,0,0,534.99,
619835016386,H004SAT,0,0,0,969.99,
619835016195,H004SE,0,0,0,709.99,
619835016393,H004SE2,0,0,0,709.99,
619835016300,H004SEM,0,0,0,749.99,
619835016317,H004SEV,0,0,0,764.99,
619835016287,H004SM,0,0,0,579.99,
619835016294,H004SV,0,0,0,589.99,
619835016607,H004SY,0,0,0,534.99,
619835016652,H004TX,0,0,0,819.99,
619835043009,H004V,0,0,0,544.99,
619835044020,H004VL,0,0,0,549.99,
619835016065,H004Y,0,0,0,484.99,
619835015006,H005,6,6,12,244.99,
619835015020,H005MG,19,10,29,244.99,
619835015013,H005S,0,0,0,244.99,
619835018007,H006,0,0,0,809.99,
619835060006,H006C,0,0,0,809.99,
619835060266,H006CD3,0,0,0,1629.99,
619835060297,H006CR,0,0,0,809.99,
619835060235,H006L,0,0,0,829.99,
619835060020,H006M,0,0,0,809.99,
619835060419,H006M327,0,0,0,809.99,
619835060426,H006M41,0,0,0,809.99,
619835060228,H006MLGL,0,0,0,829.99,
619835060303,H006MR,0,0,0,809.99,
619835060280,H006R,0,0,0,809.99,
619835090010,H009B,0,0,0,839.99,
619835090058,H009BWL,0,0,0,1134.99,
619835090089,H009G,0,0,0,784.99,
619835090096,H009GAW,0,0,0,924.99,
619835090102,H009GCC,0,0,0,924.99,
619835090119,H009GL,0,0,0,799.99,
619835090126,H009GWL,0,0,0,1299.99,
619835090140,H009X,0,0,0,804.99,
619835100047,H010B,0,0,0,839.99,
619835100085,H010BWL,0,0,0,1139.99,
619835100146,H010G,0,0,0,784.99,
619835100153,H010GAW,0,0,0,924.99,
619835100160,H010GAWP,0,0,0,989.99,
619835100177,H010GCC,0,0,0,924.99,
619835100184,H010GWL,0,0,0,1299.99,
619835100139,H010X,0,0,0,804.99,
619835100016,H011,0,0,0,2099.99,
619835110039,H011C,0,0,0,2099.99,
619835110046,H011D3,0,0,0,3059.99,
619835100054,H011IF,0,0,0,2429.99,
619835110022,H011R,0,0,0,2099.99,
619835200242,H012CX,0,0,0,804.99,
619835200266,H012G,0,0,0,784.99,
619835200273,H012GAW,0,0,0,924.99,
619835200280,H012GC,0,0,0,784.99,
619835200297,H012GCAW,0,0,0,924.99,
619835200303,H012GCC,0,0,0,924.99,
619835200310,H012GCCC,0,0,0,924.99,
619835200334,H012GCR,0,0,0,784.99,
619835200341,H012GCRCC,0,0,0,924.99,
619835200365,H012GM,0,0,0,784.99,
619835200372,H012GMAW,0,0,0,924.99,
619835200389,H012GMCC,0,0,0,924.99,
619835200402,H012GMR,0,0,0,784.99,
619835200419,H012GMRCC,0,0,0,924.99,
619835200433,H012GRCC,0,0,0,924.99,
619835200143,H012M327,0,0,0,769.99,
619835200099,H012M41,0,0,0,769.99,
619835200150,H012MR327,0,0,0,769.99,
619835200259,H012MX,0,0,0,804.99,
619835200235,H012X,0,0,0,804.99,
619835300003,H014-223,0,0,0,919.99,
619835300010,H014-243,0,0,0,919.99,
619835300027,H014-308,0,0,0,919.99,
619835300096,H014-65,0,0,0,919.99,
619835300164,H014RP-223,0,0,0,949.99,
619835300034,H014S-223,0,0,0,919.99,
619835300041,H014S-243,0,0,0,919.99,
619835300058,H014S-308,0,0,0,919.99,
619835300126,H014S-65,0,0,0,919.99,
619835300157,H014WL-308,0,0,0,1599.99,
619835400062,H015-12,2,0,2,434.99,
619835400222,H015-12S,0,0,0,459.99,
619835400079,H015-20,0,0,0,434.99,
619835400031,H015-223,0,0,0,434.99,
619835400024,H015-243,0,0,0,434.99,
619835400154,H015-3030,0,0,0,434.99,
619835400017,H015-308,0,0,0,434.99,
619835400192,H015-350,0,0,0,434.99,
619835400161,H015-357,0,0,0,434.99,
619835400086,H015-410,0,0,0,434.99,
619835400048,H015-44,0,0,0,434.99,
619835400246,H015-450,0,0,0,434.99,
619835400055,H015-4570,0,0,0,434.99,
619835400093,H015B-12,0,0,0,534.99,
619835400109,H015B-20,0,0,0,534.99,
619835400178,H015B-357,0,0,0,534.99,
619835400116,H015B-410,0,0,0,534.99,
619835400123,H015B-44,0,0,0,534.99,
619835400130,H015B-4570,0,0,0,534.99,
619835400239,H015T-12,0,0,0,559.99,
619835400147,H015Y-20,0,0,0,434.99,
619835400215,H015Y-410,0,0,0,434.99,
619835500038,H018AH-410,0,0,0,804.99,
619835500076,H018BAH-410,0,0,0,874.99,
619835500052,H018G-410,0,0,0,824.99,
619835500069,H018G-410R,0,11,11,784.99,
619835500045,H018X-410,0,0,0,804.99,
619835060457,H024-3030,0,0,0,899.99,
619835060488,H024-35,0,0,0,899.99,
619835060464,H024-3855,0,0,0,899.99,
619835060495,H024-410,0,0,0,899.99,
619835060471,H024-4570,0,0,0,899.99,
619835020000,H027-H9,0,0,0,679.99,
619835020024,H027-H9G,0,0,0,704.99,
619835020031,H027-H9S,0,0,0,704.99,
619835600424,HS-15-16-17,18,0,18,,
000000010009,HM001,19,15,34,13.99,
010524001919,HSG191,14,22,36,16.99,
619835110060,H011CFM,0,0,0,3399.99,
619835011060,H001TER,0,0,0,434.99,
619835011138,H001TMER,0,0,0,524.99,
619835016614,H004AR,0,0,0,999.99,
619835016324,H004RR,0,0,0,869.99,
619835060327,H006CS,0,0,0,859.99,
619835060334,H006MS,0,0,0,859.99,
619835060310,H006S,0,0,0,859.99,
619835060099,H006WL2,0,0,0,1139.99,
619835110077,H011D-25,0,0,0,2949.99,
727962707869,BK22A2,18,10,28,129.99,
727962706756,BK22B1BHBD,99,91,190,144.99,
727962706763,BK22B1BHGPRL,0,27,27,149.99,
727962706770,BK22B1BHWBRN2,0,32,32,149.99,
727962704646,BK22B2,0,4,4,119.99,
727962707128,BK22B2-BBK,19,19,38,124.99,
727962707135,BK22B2-GLD,0,2,2,129.99,
727962706466,BK22B2-SCNGA,99,34,133,134.99,
727962704660,BK22B2GPRL,10,42,52,149.99,
727962704677,BK22B3,0,0,0,119.99,
727962707104,BK22B3-BBK,7,41,48,124.99,
727962707111,BK22B3-GLD,23,48,71,129.99,
727962704691,BK22B3GPRL,60,30,90,149.99,
727962707852,BK22C2,11,6,17,129.99,
727962706749,BK22CH2KIT,0,0,0,194.99,
727962704653,BK22CH2WBRN10,32,47,79,144.99,
727962704684,BK22CH3WBRN10,98,99,197,144.99,
727962707906,BK22Q2,4,1,5,129.99,
727962708620,BK22Q2BHB-ROSES,12,30,42,164.99,
727962708637,BK22Q2BHW-ROSES,99,83,182,189.99,
727962707913,BK22Q3,2,8,10,129.99,
727962707890,BK22S2,15,10,25,129.99,
727962702949,RR22999CH4,37,26,63,164.99,
727962703342,RR22999CH6,11,5,16,164.99,
727962500521,RR22999MB4,11,16,27,169.99,
727962500514,RR22999MB6,51,82,133,169.99,
727962500538,RR22999MB6AS,12,14,26,179.99,
727962707784,RR22A4,0,0,0,129.99,
727962707777,RR22A6,5,0,5,129.99,
727962703366,RR22B16,0,11,11,149.99,
727962706473,RR22B16-SCNGA,99,99,198,159.99,
727962707371,RR22B16BLKPRL,92,66,158,149.99,
727962500200,RR22B4,0,0,0,119.99,
727962707081,RR22B4-BBK,12,16,28,124.99,
727962707746,RR22B4-CLAW,99,61,160,126.99,
727962707098,RR22B4-GLD,42,27,69,129.99,
727962707005,RR22B4-PINUP7,0,12,12,129.99,
727962707029,RR22B4-SNK4,3,35,38,129.99,
727962703359,RR22B4GOLDUSA,0,0,0,119.99,
727962500309,RR22B6,13,19,32,119.99,
727962707067,RR22B6-BBK,45,58,103,124.99,
727962707753,RR22B6-CLAW,99,77,176,129.99,
727962707074,RR22B6-GLD,45,63,108,129.99,
727962706992,RR22B6-PINUP7,22,23,45,129.99,
727962707012,RR22B6-SNK4,16,38,54,129.99,
727962706411,RR22B6-TH,0,0,0,154.99,
727962702901,RR22B6BLKPRL,6,2,8,119.99,
727962703168,RR22B6GOLDUSA,0,0,0,119.99,
727962707807,RR22C4,6,0,6,129.99,
727962707791,RR22C6,1,0,1,129.99,
727962510278,RR22CH4,5,24,29,134.99,
727962707173,RR22CH4-WW3,99,53,152,164.99,
727962707968,RR22CH4-WW5,99,79,178,164.99,
727962503829,RR22CH6,0,0,0,134.99,
727962707043,RR22CH6-WW3,99,89,188,164.99,
727962707951,RR22CH6-WW5,99,87,186,164.99,
727962703618,RR22MB16,35,19,54,179.99,
727962703625,RR22MB16AS,36,0,36,204.99,
727962500118,RR22MB3BH,0,0,0,154.99,
727962500217,RR22MB4,0,0,0,149.99,
727962500316,RR22MB6,0,4,4,149.99,
727962500392,RR22MB6AS,0,0,0,179.99,
727962500415,RR22MB9,99,99,198,169.99,
727962708019,RR22MCH4-WW4,61,28,89,184.99,
727962708880,RR22MCH12-WW7,0,0,0,199.99,
727962503904,RR22MCH4,0,0,0,159.99,
727962503805,RR22MCH6,0,0,0,159.99,
727962708026,RR22MCH6-WW4,99,48,147,184.99,
727962707883,RR22S4,6,0,6,129.99,
727962707876,RR22S6,8,0,8,129.99,
727962707937,RR22T4,5,7,12,129.99,
727962707920,RR22T6,5,11,16,129.99,
727962702994,RR22TT6BLKPRL,22,30,52,144.99,
727962708316,SRR22A4,16,9,25,189.99,
727962708309,SRR22A6,7,8,15,189.99,
727962708255,SRR22BS4PG,30,20,50,179.99,
727962708200,SRR22BS6PG,20,10,30,179.99,
727962708347,SRR22C4,19,8,27,189.99,
727962708286,SRR22C6,8,10,18,189.99,
727962708330,SRR22V4,0,0,0,189.99,
727962708323,SRR22V6,17,10,27,189.99,
727962703717,BR226B16,20,10,30,219.99,
727962707999,BR226B16HS-WW6,41,53,94,284.99,
727962708217,BR226B16HSGLD,6,5,11,254.99,
727962708095,BR226B16HSWB10,55,36,91,279.99,
727962708125,BR226B16HSWB11,52,35,87,284.99,
727962707975,BR226B16HSWB07,21,24,45,284.99,
727962707418,RR22B4WBN42,86,2,88,129.99,109.99
727962707401,RR22B6WBN42,99,74,173,129.99,109.99
727962707654,BR226B16HSWB05,42,55,97,284.99,244.99
727962707760,BK22B2-ROSES,89,16,105,154.99,
727962707739,BK22B2WRN14,0,11,11,129.99,
727962707715,RR22B16WRN14,49,0,49,159.99,
727962707722,RR22B4WRN14,0,9,9,129.99,
727962707425,RR22B16WBN42,0,77,77,159.99,
727962707708,RR22B6WRN14,0,53,53,129.99,
727962704783,RR22CH12-WW1,0,5,5,184.99,
727962703922,BR226B16HS-LS,3,0,3,244.99,
752334340108,34010,2,6,8,151.99,
752334345103,34510,0,0,0,151.99,
752334091604,916,5,0,5,151.99,
752334003805,CF380,49,43,92,139.99,
752334900654,JXP10,0,0,0,159.99,
752334900104,1095TS,0,0,0,324.99,
752334900111,1095TS EDGE,7,9,16,379.99,
752334900128,1095TSCA,4,5,9,387.99,
752334038074,3895TS,0,6,6,264.99,
752334500021,4595TS-HPT,1,16,17,289.99,
752334500083,4595TS4X32,7,7,14,327.99,
752334900258,4595TSCA,10,5,15,354.99,
752334600080,4595TSDD,1,8,9,334.99,
752334500038,4595TSFG-HPT,1,8,9,317.99,
752334600097,4595TSWC-HPT,5,3,8,334.99,
752334099921,995FGFLTS,19,14,33,309.99,
752334099945,995FGTS-HPT,0,14,14,299.99,
752334009951,995TS-HPT,0,0,0,269.99,
752334600219,995TS-19,31,28,59,294.99,
752334009968,995TSCA,0,52,52,334.99,
752334600028,995TSDD-HPT,9,8,17,314.99,
752334099914,995TSFG2XRB-HPT,37,11,48,339.99,
752334401113,995TSRDCT,27,16,43,339.99,314.99
752334600035,995TSWC-HPT,6,9,15,314.99,
752334001016,CLP1095,6,10,16,16.49,
752334002006,CLP3895,84,44,128,16.49,
752334995025,CLP4595RB20,24,13,37,32.99,
752334004536,CLP45P,5,20,25,16.49,
752334995001,CLP995,15,40,55,16.49,
752334995018,CLP995RB20,99,99,198,27.99,
752334000248,CLP9C/380,16,18,34,13.99,
752334600011,FFG,0,1,1,18.99,
752334900548,916FDE-BLK,90,79,169,184.99,
752334900401,4595TS-HPT-FLG,15,0,15,344.99,
752334600134,995TS-FDE,0,5,5,,
752334900395,995TS-FLG,12,0,12,339.99,
743108161623,16162,5,5,10,,
743108241103,24110,4,0,4,,
743108241165,24116,10,3,13,,
743108241202,24120-HOG,11,8,19,,
743108241400,24140-HOG,10,4,14,,
743108241608,24160-HOG,13,9,22,,
743108241622,24162-HOG,15,8,23,,
743108241707,24170-HOG,13,5,18,,
743108241721,24172,11,7,18,,
743108242636,24263,34,23,57,,
743108242735,24273-HOG,19,21,40,,
743108242766,24276,19,23,42,,
743108242773,24277,26,26,52,,
743108242797,24279,48,28,76,,
743108243633,24363,31,15,46,,
743108243664,24366,54,36,90,,
743108243671,24367,47,26,73,,
743108243732,24373,33,17,50,,
743108243763,24376,40,23,63,,
743108243770,24377,45,27,72,,
743108340264,34026,1,2,3,,
743108340561,34056,0,0,0,,
743108345597,34559,33,19,52,,
743108345795,34579,16,3,19,,
743108347744,34774,10,0,10,,
743108347768,34776,10,9,19,,
743108351291,35129,3,0,3,,
743108351789,35178,5,4,9,,
743108357774,35777,6,10,16,,
743108357781,35778,0,0,0,,
743108357798,35779,1,0,1,,
743108358641,35864,20,12,32,,
743108358696,35869,20,8,28,,
743108358740,35874,30,15,45,,
743108358764,35876,0,0,0,,
743108363201,36320-HOG,34,20,54,,
743108363225,36322-HOG,12,5,17,,
743108363232,36323,25,14,39,,
743108363300,36330,23,21,44,,
743108363324,36332,16,5,21,,
743108363331,36333,4,15,19,,
743108363607,36360,34,22,56,,
743108363638,36363,30,18,48,,
743108363706,36370,44,20,64,,
743108363737,36373,34,5,39,,
743108365304,36530,5,0,5,,
743108365328,36532,9,6,15,,
743108365700,36570,40,20,60,,
743108365724,36572,18,2,20,,
743108371756,37175,0,5,5,,
743108373200,37320-HOG,11,8,19,,
743108373224,37322,13,6,19,,
743108540008,54000,6,0,6,,
743108540107,54010,0,0,0,,
743108540305,54030,22,16,38,,
743108540329,54032-HOG,26,7,33,,
743108540565,54056,11,4,15,,
743108540961,54096,0,0,0,,
743108541500,54150-HOG,18,6,24,,
743108541562,54156-HOG,22,9,31,,
743108641200,64120-HOG,28,22,50,,
743108641231,64123,24,10,34,,
743108641330,64133,14,8,22,,
743108641361,64136,19,16,35,,
605930625455,LE117-GR,4,4,8,291.99,
605930625523,LE117-IR,0,2,2,,
605930625516,LE117-R,2,2,4,,
605930625462,LE221-GR-IR,1,0,1,532.89,
605930625561,LE221-RD-IR,1,1,2,,
605930625479,LE321-GR,2,0,2,766.49,
605930625592,LE321-RD,0,0,0,,
605930625486,LE420-GR,0,0,0,875.99,
605930624601,LS117G,2,0,2,213.2,
605930624625,LS117IR,4,1,5,186.29,
605930624618,LS117R,1,2,3,186.29,
605930624632,LS221G,1,0,1,,
605930624649,LS221R,1,1,2,358.79,
605930624656,LS321G,3,1,4,569.24,
605930624663,LS321R,0,0,0,531.29,
605930624670,LS420G,0,0,0,641.69,
810047071747,P.ID,22,9,31,79.34,
810047072485,P.ID HC,0,0,0,117.29,
810047072294,P.ID-DUAL,2,0,2,165.59,
810047071754,P.ID-PLUS,0,0,0,117.29,
810047071730,RMLT-GR,0,0,0,102.19,
810047071532,507C-PIC-MOUNT,65,50,115,13.79,
810047071075,509PLT-0.82-PIC,0,0,0,27.59,
810047071082,509PLT-1.63-PIC,1,4,5,41.39,
810047071051,509PLT-507C,6,3,9,27.59,
810047071006,509PLT-CZP10,12,9,21,27.59,
810047071037,509PLT-FN509,0,0,0,27.59,
810047071044,509PLT-FNX45,0,0,0,27.59,
810047071020,509PLT-MOS9MM,99,0,99,27.59,27.59
605930624960,510C-SPACER,0,0,0,13.79,
605930625721,HS510C/HM3X,90,22,112,,
810047071228,AEMS-RD,82,53,135,315.99,
810047071549,AEMS-GR,62,10,72,339.69,339.69
810047071235,AEMS/CORE110101,18,10,28,236.99,236.99
810047071556,AEMS/CORE120101,48,61,109,248.84,248.84
810047071655,AEMS-LOW-MOUNT,0,0,0,20.69,
810047072935,DRS-NV,0,0,0,789.99,
810047072249,EPS-CARRY-GR-2,0,0,0,272.54,
810047072287,EPS-CARRY-GR-6,0,0,0,272.54,
810047071594,EPSCARRY-GR-MRS,0,0,0,339.69,
810047072225,EPS-CARRY-RD-2,0,0,0,260.69,
810047072263,EPS-CARRY-RD-6,0,0,0,260.69,
810047071570,EPSCARRY-RD-MRS,0,0,0,315.99,
810047072232,EPS-GR-2,0,0,0,272.54,
810047072270,EPS-GR-6,0,0,0,272.54,
810047071587,EPS-GR-MRS,0,0,0,339.69,
810047072218,EPS-RD-2,88,49,137,260.69,
810047072256,EPS-RD-6,0,0,0,260.69,
810047071563,EPS-RD-MRS,0,0,0,315.99,
605930625158,HE403B-GR-FDE,46,44,90,143.07,
605930624793,HE403B-GR,17,0,17,143.07,
605930624809,HE403C-GR,27,6,33,164.24,
605930625387,HE403R-GD,3,4,7,143.07,
810047071259,HE407C-GR-X2,66,39,105,189.79,
810047071372,HE407K-GR-X2,99,44,143,175.19,
605930624823,HE503CU-GR,16,73,89,216.07,
605930625394,HE503R-GD,0,0,0,208.77,
810047071280,HE507C-GR-X2,99,13,112,248.19,
810047072911,HE507COMP-GR,0,0,0,291.99,
810047071389,HE507K-GR-X2,99,99,198,233.59,
810047071273,HE508T-GR-X2,27,22,49,,
810047071242,HE508T-RD-X2,40,16,56,291.99,
605930625868,HE509T-GR-X2,0,0,0,,
810047071600,HE509T-RD-X2,13,36,49,313.89,
605930624878,HE510C-GR,47,44,91,248.19,
605930624885,HE512T-GR,0,0,0,386.89,
605930624748,HE512T-RD,0,0,0,364.99,
605930624892,HE515CM-GR,5,1,6,277.39,
605930624915,HE515CT-GR,6,4,10,335.79,335.79
605930625004,HE515CT-RD,0,0,0,313.89,
605930624908,HE515GM-GR,3,4,7,255.49,
605930624922,HE515GT-GR,1,1,2,313.89,
605930625011,HE515GT-RD,2,1,3,291.99,
605930624939,HE530C-GR,0,0,0,386.89,
605930624519,HE530C-RD,0,0,0,364.99,
605930624946,HE530G-GR,0,0,0,364.99,
605930624526,HE530G-RD,2,1,3,343.09,
605930625271,HM3X,69,39,108,137.99,137.99
810047071150,HM3XT,16,13,29,,
760921087428,HS403B,22,35,57,124.19,
605930624762,HS403B-FDE,28,9,37,124.19,124.19
760921087374,HS403C,22,1,23,,
605930625295,HS403R,26,21,47,124.19,
810047071181,HS407C-X2,61,41,102,169.04,
810047071204,HS407K-X2,99,97,196,155.24,
605930624540,HS503CU,29,8,37,180.08,
605930625301,HS503R,14,4,18,175.94,175.94
810047071174,HS507C-X2,99,53,152,213.89,
810047072928,HS507COMP,0,0,0,255.29,
810047071211,HS507K-X2,99,96,195,204.23,
605930624571,HS510C,99,99,198,213.89,
605930624953,HS510C-FDE-G,41,34,75,248.19,
605930624991,HS510C-FDE-R,36,13,49,213.89,
605930624700,HS515CM,1,7,8,241.49,
605930624717,HS515GM,2,2,4,220.79,
760921087671,HSCQD1,0,0,0,41.39,
810047071167,KPLT-507C,0,0,0,27.59,
810047071129,KPLT-CZP10C,13,10,23,27.59,
810047071112,KPLT-FN509,0,0,0,27.59,
810047071136,KPLT-MOS9MM,0,0,0,27.59,
810047072898,SCRS-GR-2,0,0,0,178.84,
810047072874,SCRS-GR-MRS,0,0,0,218.99,
810047072904,SCRS-RD-2,0,0,0,167.89,
810047072881,SCRS-RD-MRS,0,0,0,197.09,
810047072836,SCS-320-GR,0,0,0,315.99,
810047071679,SCS-M-GR,0,0,0,276.49,
810047072645,SCS-MP2-GR,99,99,198,276.49,
810047072850,SCS-PDP-GR,0,0,0,276.49,
810047072638,SCS-VP9-GR,0,0,0,276.49,
026285510324,1202,29,8,37,1.02,
026285510331,1203-HOP,99,0,99,1.02,
026285510348,1204,2,14,16,,
026285515114,1204S,35,14,49,5.19,
026285510355,1205,36,15,51,1.02,
026285511055,1218,90,31,121,2.39,2.39
026285513851,1305P,0,14,14,1.19,
026285513899,1308P,10,10,20,1.19,
026285513837,1314P,12,6,18,1.49,
026285000948,24002D,12,2,14,8.29,
026285001297,24002VD,2,23,25,11.19,
026285000955,24003D,0,0,0,8.29,
026285001303,24003VD,27,37,64,11.19,
026285000962,24004D,6,2,8,8.29,
026285001310,24004VD,2,13,15,11.19,
026285000993,24011D,0,0,0,8.29,
026285001327,24011VD,26,11,37,11.19,
026285001044,24015D,3,1,4,8.29,
026285001358,24015VD,7,11,18,11.19,
026285001150,24033D,0,0,0,8.29,7.99
026285001419,24033VD,6,8,14,11.19,9.99
026285001174,24035D,0,0,0,8.29,7.99
026285001426,24035VD,1,7,8,11.19,9.99
026285001099,24090D,4,2,6,8.29,
026285012545,FEPKD30,0,15,15,24.99,
090255713763,95200-HRN,0,0,0,23.49,
090255713770,95210-HRN,0,0,0,24.99,
090255954302,95430,0,1,1,104.99,
090255981537,98153,0,0,0,35.99,
090255981728,98172,0,0,0,179.99,
090255982107,98210,2,4,6,199.99,
090255982152,98215,0,0,0,209.99,
682146878318,HCRACF65CUSA,7,10,17,1699.99,
682146878325,HCRACF65CUSG,5,3,8,1699.99,
682146878110,HCSL308KAC,2,2,4,919.99,
682146878127,HCSL308KOT,6,4,10,919.99,
682146892178,HCSL65CRKAC,7,3,10,919.99,
682146892185,HCSL65CRKOT,3,4,7,919.99,
682146398663,HGP2243B,1,4,5,569.99,
682146398670,HGP2243G,0,0,0,569.99,
682146398472,HGP2250B,0,0,0,569.99,
682146398489,HGP2250G,0,0,0,569.99,
682146398496,HGP2270B,0,2,2,609.99,
682146398502,HGP2270G,0,2,2,609.99,
682146398519,HGP23006B,0,1,1,609.99,
682146398526,HGP23006G,4,10,14,609.99,
682146398533,HGP2300B,0,0,0,634.99,
682146398540,HGP2300G,0,0,0,634.99,
682146398434,HGP2308B,4,5,9,569.99,
682146398441,HGP2308G,0,3,3,569.99,
682146398571,HGP23PRCB,1,0,1,634.99,
682146398588,HGP23PRCG,0,0,0,634.99,
682146398410,HGP265B,23,11,34,569.99,
682146398427,HGP265G,17,4,21,569.99,
682146398601,HGP265PRCG,8,0,8,634.99,
682146398458,HGP2708B,3,0,3,569.99,
682146398465,HGP2708G,1,3,4,569.99,
682146398557,HGP27MMB,0,6,6,634.99,
682146398564,HGP27MMG,0,3,3,634.99,
682146398786,HGR71232,0,0,0,459.99,
682146398793,HGR71233,0,0,0,459.99,
682146398809,HGR72132,0,1,1,459.99,
682146398816,HGR72133,0,0,0,459.99,
682146398823,HGR72532,17,9,26,459.99,
682146398830,HGR72533,11,10,21,459.99,
682146398861,HGR72632,0,0,0,479.99,
682146398878,HGR72633,0,4,4,479.99,
682146398847,HGR73132,3,3,6,459.99,
682146398854,HGR73133,1,0,1,459.99,
682146398885,HGR73232,10,0,10,479.99,
682146398892,HGR73233,2,2,4,479.99,
682146398908,HGR73332,0,0,0,479.99,
682146398915,HGR73333,0,0,0,479.99,
682146398946,HGR73532,0,0,0,479.99,
682146398953,HGR73533,0,0,0,479.99,
682146398922,HGR73732,2,0,2,479.99,
682146398939,HGR73733,0,5,5,479.99,
682146398960,HGR75532,14,15,29,479.99,
682146398977,HGR75533,8,12,20,479.99,
682146390032,HMA70622+,0,0,0,459.99,
682146390049,HMA70623+,0,0,0,459.99,
682146394399,HORX72503,0,0,0,799.99,
682146119725,HRF22LR,1,3,4,399.99,
682146119718,HRF22LRB,4,3,7,399.99,
682146119817,HWH22LRT,2,1,3,489.99,
682146399677,HWH243T,0,0,0,549.99,
682146399660,HWH250T,0,0,0,549.99,
682146399707,HWH270T,0,0,0,569.99,
682146399714,HWH3006T,0,0,0,569.99,
682146399738,HWH300T,0,0,0,569.99,
682146399745,HWH308T,0,0,0,549.99,
682146399769,HWH308TS,0,0,0,689.99,
682146399684,HWH65CT,0,0,0,549.99,
682146399752,HWH65CTS,0,0,0,689.99,
682146399776,HWH65PRCT,0,0,0,569.99,
682146399691,HWH708T,0,0,0,549.99,
682146399721,HWH7MMT,0,0,0,569.99,
682146398625,HFLG30816,7,2,9,1329.99,
682146398618,HFLG65C16,15,15,30,1329.99,
682146119091,HDAV3PRC,0,0,0,389.99,
682146119053,HDAV65C,0,0,0,379.99,
682146394658,HORX72504,0,0,0,799.99,
689585854743,1110002,0,0,0,199.99,
713440970672,1302032,8,7,15,224.99,
689585854729,710203,0,12,12,224.99,
856304004745,J941F9,13,4,17,499.0,
856304004967,J941FS9,13,7,20,499.0,
818004020777,J941PL9-II,15,9,24,429.0,
818004021422,J941PSL9-II,17,10,27,429.0,
818004021644,J941R9,0,0,0,499.0,
818004020401,M9ORP10,0,0,0,384.0,
818004020838,M9ORP17,52,34,86,384.0,
818004021026,M9ORP17FD,54,39,93,384.0,
818004023013,M9ORP17NS,10,10,20,464.0,
818004021736,M9ORP17T,15,17,32,384.0,
818004021958,M9ORP17TFD,18,19,37,384.0,
818004022153,M9SLIM13,0,23,23,360.0,360.0
818004023136,M9SLIM13NS,0,0,0,440.0,
818004022399,GAR27,0,0,0,1584.0,
818004021835,CSR16,0,0,0,1440.0,
818004022375,GAR37,0,0,0,1584.0,
818004020364,T7B16,0,0,0,1760.0,
818004022511,T7B20,0,0,0,1760.0,
818004022528,T7F20,0,0,0,1760.0,
818004020371,T7FD16,0,0,0,1760.0,
818004020340,TS12B,7,15,22,1120.0,
818004021651,TS12B-LH,1,4,5,,
818004020357,TS12F,9,9,18,1120.0,
859735005916,XB16,0,0,0,1586.0,
859735005923,XFD16,0,0,0,1586.0,
859735005930,XG16,0,0,0,1586.0,
818004021392,Z15TAC16,0,0,0,720.0,
818004023433,Z15TAC16DT,0,0,0,800.0,
818004020524,MAS917,0,0,0,22.0,
617717213007,1300,36,15,51,,
617717299094,9909-KBA,42,67,109,,
617717211195,1119,30,29,59,,
617717211218,1121,12,26,38,,
617717212116,1211-KBA,12,4,16,,
617717212130,1213-KBA,15,19,34,,
617717212147,1214-KBA,9,2,11,,
617717212178,1217-KBA,43,28,71,,
617717212185,1218-KBA,16,29,45,,
617717212208,1220,36,21,57,,
617717212451,1245-KBA,10,7,17,,
617717212499,1249,23,10,33,,
617717212505,1250,12,8,20,,
617717212581,1258,16,6,22,,
617717212666,1266,12,4,16,,
617717212697,1269,12,7,19,,
617717212741,1274,10,11,21,,
617717212925,1292,15,10,25,,
617717313134,1313SF,11,12,23,,
617717213205,1320-KBA,12,7,19,,
617717214806,1480,55,31,86,,
617717014802,1480SF,13,3,16,,
617717214813,1481,14,1,15,,
617717214820,1482,9,3,12,,
617717214936,1493,8,5,13,,
617717230509,3050,9,6,15,,
617717230622,3062,6,7,13,,
617717230660,3066,66,52,118,,
617717230677,3067-KBA,42,15,57,,
617717230721,3072-KBA,15,16,31,,
617717230776,3077-KBA,19,13,32,,
617717230851,3085-KBA,37,30,67,,
617717230868,3086-KBA,30,32,62,,
617717231896,3189,12,26,38,,
617717240621,4062,24,10,34,,
617717640629,4062BO,9,8,17,,
617717704628,4062D2,10,8,18,,
617717240720,4072,9,7,16,,
617717356988,5698SF,14,7,21,,
617717275036,7503-KBA,0,0,0,,
617717275111,7511,13,9,22,,
617717299261,9926,29,22,51,,
617717200168,BK16,10,4,14,,
617717200182,BK18,18,18,36,,
617717200021,BK2,18,5,23,,
617717200403,BK40,41,8,49,,
617717200076,BK7,12,4,16,,
617717200090,BK9,6,8,14,,
602686422543,1911TCA12N,10,11,21,1464.99,
602686422505,1911TCAC11N,15,15,30,1319.99,
602686422581,1911TCAC14,38,45,83,1314.99,
602686127318,CM4543,1,2,3,364.99,
602686067317,CM9093,23,38,61,364.99,
602686067393,CM9093N,26,39,65,399.99,
602686177313,CT3833,8,0,8,314.99,
602686117319,CT4543,1,22,23,339.99,
602686087315,CT9093,13,0,13,339.99,
602686167314,CW3833,4,3,7,314.99,
602686167390,CW3833N,6,20,26,349.99,
602686107310,CW4543,5,4,9,349.99,
602686047319,CW9093,1,3,4,349.99,
602686421225,CW9093BB,0,0,0,379.99,
602686047395,CW9093N,0,5,5,379.99,
602686047012,K9093A,10,4,14,719.99,
602686168595,KP38233N,0,14,14,594.99,
602686168298,KP3834N,3,3,6,579.99,
602686046497,KP90S94N,17,34,51,469.99,
602686067010,M9093,0,3,3,719.99,
602686068093,PM9093NA,13,0,13,594.99,
602686068291,PM9094NA,0,0,0,594.99,
602686086493,TP90S94N,35,20,55,469.99,
602686160124,K386,0,0,0,30.99,
602686108027,K625,0,2,2,30.99,
602686128070,K625G,0,4,4,32.99,
602686090223,K720G,2,3,5,32.99,
602686108072,K725G,0,0,0,32.99,
602686040129,K820,5,5,10,30.99,
002686040226,K920G,5,0,5,,
602686150224,KS620,0,5,5,30.99,
602686060127,MK620,0,0,0,30.99,
602686060226,MK720,0,5,5,30.99,
851586008603,KCI-MZ004-S,7,5,12,63.99,
851586008092,KCI-MZ005,0,0,0,8.99,
851586008139,KCI-MZ018-BP,0,21,21,7.99,7.49
851586008528,KCI-MZ050,46,99,145,19.99,
851586008016,KCI-MZ001,13,99,112,110.99,
851586008122,KCI-MZ006,0,1,1,9.99,
851586008184,KCI-MZ007,99,99,198,8.99,
851586008238,KCI-MZ008,99,99,198,12.49,
851586008191,KCI-MZ009,99,0,99,8.49,
851586008177,KCI-MZ012,27,0,27,13.99,12.99
851586008207,KCI-MZ013,1,99,100,13.99,12.99
851586008252,KCI-MZ026,57,1,58,13.99,
851586008078,KCI-MZ027,99,0,99,49.99,
851586008061,KCI-MZ028,39,2,41,54.99,
851586008146,KCI-MZ030,99,71,170,10.99,
851586008108,KCI-MZ033,0,0,0,7.49,
851586008115,KCI-MZ034,43,0,43,7.99,
851586008290,KCI-MZ038,99,0,99,9.99,8.99
851586008320,KCI-MZ039,99,99,198,9.99,
851586008009,KCI-MZ029,36,21,57,69.99,
640832007756,CP33,0,0,0,399.99,
640832008777,P15BLK,0,0,0,299.99,
640832007909,P17BLK,0,0,0,174.99,
640832000450,P-32,0,0,0,244.99,
640832008579,P50BLK,0,0,0,699.99,
640832000375,PLR-16,0,0,0,509.99,
640832004021,PLR-16-CK-GREEN,0,0,0,569.99,
640832004014,PLR-16-CK-TAN,0,0,0,569.99,
640832000405,PLR-22,0,0,0,299.99,
640832002676,PMR-30,0,0,0,339.99,
640832003307,PMR-30-CK-GREEN,0,0,0,379.99,
640832005011,PMR-30-CK-TTNM,0,60,60,399.99,
640832004618,CMR30BLK,0,0,0,539.99,
640832006803,CMR-30-CK-TTNM,0,0,0,619.99,
640832007787,KS7BLK,0,0,0,459.99,
640832007794,KS7GRN,33,51,84,524.99,494.99
640832007800,KS7TAN,19,3,22,524.99,
640832007954,KS7TTM,99,83,182,549.99,
640832007367,KSG-25,0,0,0,929.99,
640832003192,KSG,0,0,0,659.99,
640832003284,KSG-CK-GREEN,0,0,0,719.99,
640832003291,KSG-CK-TAN,0,0,0,719.99,
640832003895,KSG-CK-TTNM,0,0,0,749.99,
640832005974,RDB20BLK,0,0,0,949.99,
640832005943,RDBBLK,0,0,0,879.99,
640832002720,RDBGRN,0,0,0,949.99,
640832005967,RDBTAN,0,0,0,949.99,
640832007381,RFB18,0,0,0,1459.99,
640832000795,SU-16,0,0,0,509.99,
640832000818,SU-16A-CK-GREEN,0,0,0,569.99,
640832003932,SU-16A-CK-TAN,0,0,0,569.99,
640832000825,SU-16B,0,0,0,549.99,
640832000955,SU-16B-CK-GREEN,0,0,0,609.99,
640832003956,SU-16B-CK-TAN,0,0,0,609.99,
640832000856,SU-16CA,0,0,0,599.99,
640832000832,SU-16C,0,0,0,599.99,
640832003994,SU-16C-CK-GREEN,0,0,0,659.99,
640832000900,SU-22CA,0,0,0,374.99,
640832000948,SU-22C,0,0,0,389.99,
640832004090,SUB-2K40GLK2215,0,0,0,399.99,
640832004120,SUB-2K40G22BT15,10,25,35,459.99,439.99
640832004182,SUB-2K9G1717,0,0,0,429.99,
640832004243,SUB-2K9G17BG17,0,0,0,489.99,
640832004212,SUB-2K9G17BT17,0,0,0,489.99,
640832004816,SUB-2K9GLK19 15,0,0,0,429.99,
640832007862,CP33-1333,82,3,85,46.99,
640832001723,PMR30-36,99,99,198,25.99,
087171051963,1025CUX,55,30,85,,
087171047515,1025FB36,4,53,57,,
087171033594,1077-KER,54,39,93,,
087171057965,1083,62,21,83,,
087171060644,1190,51,36,87,,
087171062341,1195,29,19,48,,
087171055169,1365-KER,99,86,185,,
087171061559,1369,69,15,84,,
087171057637,1370-KER,61,25,86,,
087171057910,1375-KER,51,62,113,,
087171061986,1376-KER,60,27,87,,
087171061764,1401,82,26,108,,
087171064352,1404-KER,58,28,86,,
087171064420,1407,60,30,90,,
087171033686,1555TI,99,28,127,,
087171044781,1557TI,73,18,91,,
087171052380,1559,33,42,75,,
087171160009,1600-KER,59,29,88,,
087171160276,1600PINK,58,21,79,,
087171031491,1605CKTST,37,33,70,,
087171162201,1620FL,99,41,140,,
087171035178,1620NB,21,24,45,,
087171035192,1620OL,96,29,125,,
087171035154,1620PUR,82,24,106,,
087171064048,1645,49,30,79,,
087171064055,1645BLKST,51,28,79,,
087171166001,1660,93,49,142,,
087171048550,1660CF,27,19,46,,
087171166049,1660CKT,57,35,92,,
087171058078,1660CU,83,9,92,,
087171035116,1660OL,99,0,99,,
087171035130,1660OR,50,22,72,,
087171035093,1660PUR,78,25,103,,
087171060965,1660RBW,79,17,96,,
087171037561,1660TEAL,81,10,91,,
087171167008,1670BLK,99,0,99,,
087171167107,1670BLKST,62,30,92,,
087171033761,1670GBBLKST,99,46,145,,
087171031644,1670OLBLK,99,30,129,,
087171039084,1747BWX,90,99,189,,
087171058474,1776OLSW,99,76,175,,
087171058481,1812OLCB,99,40,139,,
087171183008,1830,99,75,174,,
087171064062,1845,60,30,90,,
087171063416,1882,77,23,100,,
087171063423,1883-KER,79,24,103,,
087171040721,1890RBX,32,6,38,,
087171058603,1891,75,26,101,,
087171030319,1920-KER,99,27,126,,
087171046105,1935-KER,70,21,91,,
087171044774,1955,51,60,111,,
087171039336,1987,99,89,188,,
087171033044,1990,81,34,115,,
087171062143,2032-KER,87,23,110,,
087171063225,2033,89,26,115,,
087171063232,2034,89,27,116,,
087171063683,2036,51,30,81,,
087171063966,2037-KER,42,21,63,,
087171063973,2038-KER,41,18,59,,
087171063959,2039-KER,30,18,48,,
087171063980,2041-KER,41,21,62,,
087171063997,2042-KER,41,19,60,,
087171064543,2044,42,21,63,,
087171062082,2049-KER,83,27,110,,
087171063621,2060,41,21,62,,
087171063188,2064-KER,73,21,94,,
087171063928,2078,30,18,48,,
087171060859,2085,45,27,72,,
087171040912,2200,78,20,98,,
087171253503,2535,40,49,89,,
087171058993,2556,37,16,53,,
087171055749,3445-KER,69,74,143,,
087171060392,3455-KER,86,27,113,,
087171036977,4007,99,44,143,,
087171039459,4008X,39,18,57,,
087171062099,4320,71,0,71,,
087171058214,4381-KER,80,21,101,,
087171058207,4382-KER,70,10,80,,
087171058283,4383,49,21,70,,
087171061771,4384,82,25,107,,
087171058412,5150,99,27,126,,
087171060446,5150BW,77,14,91,,
087171063287,5150CF,26,8,34,,
087171060187,5150TR,31,10,41,,
087171064512,5560,60,28,88,,
087171056166,6034D2,64,36,100,,
087171037592,6054BRNBLK,63,28,91,,
087171037615,6074OLBLK,65,21,86,,
087171039534,7100BW,30,11,41,,
087171055008,7150,37,24,61,,
087171055237,7250,79,37,116,,
087171055220,7350,99,41,140,,
087171041100,7500BLK,99,42,141,,
087171058771,7550,64,17,81,,
087171060620,7650,99,18,117,,
087171044484,7800BLK,99,51,150,,
087171062105,7850-KER,72,20,92,,
087171048574,7900GRYBLK,99,43,142,,
087171064529,7950-KER,0,0,0,,
087171033853,8100-KER,23,15,38,,
087171061061,8320BLK,75,31,106,,
087171048529,8650-KER,86,77,163,,
087171056616,8655,67,18,85,,
087171037134,8700BLK,78,43,121,,
087171054063,8710,65,19,84,,
087171048932,8720-KER,98,52,150,,
087171048345,8750TOLBW,67,41,108,,
087171039343,8750TTANBW,78,61,139,,
087171064550,9000,0,0,0,,
087171036236,1556BW,16,22,38,,
682146870015,BRLLSC,62,28,90,99.99,
9420001434269,NDSI3942,0,0,0,,
9420001438236,NPGI3940BO,0,0,0,119.99,
9420001438915,NRD25H,0,0,0,,
9420001436287,NSFFP41644HMD,0,0,0,189.99,
682146855319,NSFFP3441644HMD,0,0,0,229.99,
682146855326,NSFFP3441644PRR,0,0,0,229.99,
9420001437864,NSFFP41644PRR,0,0,0,189.99,
9420001436294,NSFFP62450HMD,0,0,0,189.99,
682146211263,NSMQR34MM,0,0,0,,
9420008964325,NSTT41644MD1,0,0,0,99.99,
9420001436188,ZNGKI351044AOPL,0,0,0,89.99,
,LBP/HEMI,0,0,0,,
,LBP2121,0,0,0,,
,LBP2302,0,0,0,,
,LBP2302-1.5,0,0,0,,
,LBP2302-NS,0,0,0,,
,LBP2302-T,0,0,0,,
,LBP2302-T-1.5,5,0,5,,
,LBP2302/10MM,0,0,0,,
,LBP2302/10MM1.5,0,0,0,,
,LBP2302/10MM/6,0,0,0,,
,LBP230210MM61.5,0,0,0,,
,LBP2302/HEAVY,0,0,0,,
,LBP2303,0,0,0,,
,LBP2303-1.5,0,0,0,,
,LBP2303/6,0,0,0,,
,LBP2304,0,0,0,,
,LBP2304-1.5,0,0,0,,
,LBP2305,0,0,0,,
,LBP2305-1.5,0,0,0,,
,LBP2313,0,0,0,,
,LBP2314,0,0,0,,
,LBP2315,0,0,0,,
,LBP2315-1.5,0,0,0,,
,LBP2315-HVY-1.5,0,0,0,,
,LBP2315/COM,0,0,0,,
,LBP2315/COM/9MM,0,0,0,,
LBP2315/HVY3,LBP2315/HVY,0,0,0,2330.0,
,LBP2317,0,0,0,,
,LBP2318,0,0,0,,
,LBP2319,0,0,0,,
,LBP429/BOSS,0,0,0,,
,LBP8002,0,0,0,,
,LBP8004,0,0,0,,
,LBP8004/6,0,0,0,,
,LBP8005,0,0,0,,
,LBP8006,0,0,0,,
,LBP9001,0,0,0,,
,LBP9001/TAC-1.5,0,0,0,,
,LBP9002,0,0,0,,
,LBP9003/CM,0,0,0,,
,LBP9011,0,0,0,,
,LBP9601-1.5,0,0,0,,
,LBP2319-1.5,0,0,0,,
100080310003,LBCP8031/SS8,0,0,0,,
,LBP9001-1.5FRT,0,0,0,,
,LBP9001-1.5STD,8,0,8,,
,LBP9001-1.5,0,0,0,,
030317108267,110826,0,0,0,1994.0,
030317005856,119688,0,0,0,349.0,
030317006518,120180,1,0,1,111.98,
030317006747,120371,0,2,2,1034.0,
030317006778,120372,1,1,2,1108.0,
030317006730,120373,2,0,2,1182.0,
030317008505,170385,10,4,14,9.0,
030317010454,170744,0,6,6,50.98,
030317010430,170745,8,2,10,50.98,
030317010461,170746,1,3,4,50.98,
030317010423,170748,11,12,23,50.98,
030317010447,170749,0,4,4,50.98,
030317010386,170753,0,1,1,50.98,
030317012045,171332,1,0,1,30.98,
030317011819,171333,0,2,2,30.98,
030317012021,171334,0,3,3,30.98,
030317011895,171335,0,6,6,30.98,
030317011826,171336,1,6,7,30.98,
030317011963,171337,13,3,16,30.98,
030317011833,171338,2,4,6,30.98,
030317011857,171339,0,2,2,30.98,
030317011901,171340,0,0,0,30.98,
030317012052,171341,0,3,3,30.98,
030317011918,171342,0,0,0,,
030317011925,171343,2,2,4,30.98,
030317011970,171344,0,0,0,30.98,
030317011987,171346,2,4,6,30.98,
030317012038,171347,1,4,5,30.98,
030317012076,171348,0,0,0,30.98,
030317011864,171349,0,0,0,30.98,
030317012083,171354,0,0,0,30.98,
030317011888,171355,0,0,0,30.98,
030317011956,171358,0,2,2,30.98,
030317012090,171359,0,3,3,30.98,
030317012106,171360,2,1,3,30.98,
030317012069,171361,2,3,5,30.98,
030317012144,171386,4,4,8,813.0,
030317012151,171389,15,13,28,887.0,
030317012212,171390,14,8,22,1108.0,
030317012267,171478,0,6,6,16.98,
030317012274,171479,0,0,0,16.98,
030317012281,171498,0,0,0,50.98,
030317012243,171499,0,9,9,50.98,
030317012250,171500,0,0,0,50.98,
030317012298,171514,0,0,0,30.98,
030317012304,171515,0,0,0,30.98,
030317012441,171552,10,7,17,1182.0,1131.99
030317012373,171563,2,2,4,1330.0,
030317012410,171565,11,11,22,1404.0,1359.99
030317012656,171568,0,0,0,1551.0,
030317012694,171572,17,15,32,1477.0,
030317012663,171573,0,0,0,1625.0,
030317012397,171576,0,0,0,1625.0,
030317012502,171579,25,6,31,1625.0,
030317012793,171700,4,2,6,1404.0,
030317012809,171701,0,0,0,1256.0,
030317012830,171707,0,2,2,20.98,
030317012861,171714,28,25,53,813.0,
030317012854,171715,68,49,117,813.0,754.99
030317012847,171716,4,7,11,,
030317012878,171717,10,7,17,1034.0,
030317012908,171772,1,0,1,1671.0,
030317012939,171773,1,1,2,1822.0,
030317012922,171775,1,0,1,1897.0,
030317012953,171777,0,0,0,2277.0,
030317013073,171910,0,0,0,444.0,
030317013875,172367,4,6,10,887.0,
030317013851,172368,85,0,85,887.0,
030317013981,172457,2,1,3,1034.0,
030317015091,172662,0,0,0,444.0,
030317015312,172666,0,2,2,444.0,
030317015336,172670,1,1,2,517.0,
030317015343,172675,2,1,3,569.0,
030317015633,172754,0,0,0,1551.0,
030317016357,173296,0,0,0,1518.0,
030317016371,173297,4,1,5,1671.0,
030317016364,173299,2,1,3,1744.0,
030317017576,173805,5,2,7,355.0,
030317017743,174079,0,4,4,46.98,
030317017873,174080,0,0,0,46.98,
030317017712,174081,22,3,25,46.98,
030317017811,174082,0,0,0,46.98,
030317017828,174083,0,5,5,52.98,
030317017835,174084,0,9,9,52.98,
030317017729,174085,0,5,5,52.98,
030317017781,174086,0,3,3,55.98,
030317018719,174179,0,0,0,222.0,
030317018740,174181,0,0,0,,
030317018788,174182,57,67,124,222.0,
030317018764,174184,18,0,18,222.0,
030317018016,174377,3,2,5,9.0,
030317018030,174384,0,2,2,9.0,
030317018313,174483,4,1,5,739.0,
030317018405,174546,0,0,0,1973.0,
030317018528,174682,0,1,1,30.98,
030317018504,174683,1,5,6,30.98,
030317018559,174684,3,1,4,30.98,
030317018511,174685,12,8,20,30.98,
030317018573,174686,0,0,0,30.98,
030317018542,174688,10,1,11,30.98,
030317018566,174689,4,3,7,30.98,
030317018979,175074,0,0,0,259.0,
030317018993,175081,0,0,0,370.0,
030317019129,175116,5,1,6,78.98,
030317019099,175117,0,2,2,78.98,
030317019136,175119,11,11,22,78.98,
030317019143,175120,2,5,7,78.98,
030317019105,175121,3,9,12,78.98,
030317019150,175122,7,8,15,78.98,
030317019167,175123,0,0,0,78.98,
030317020514,175856,2,2,4,887.0,
030317020538,175860,7,20,27,55.98,
030317020620,175911,2,1,3,1330.0,
030317020835,176011,0,0,0,222.0,
030317020996,176389,0,0,0,30.98,
030317021023,176394,0,2,2,30.98,
030317021054,176395,8,15,23,30.98,
030317020989,176396,3,0,3,30.98,
030317020972,176397,0,0,0,30.98,
030317021108,176445,0,0,0,1518.0,
030317021122,176448,1,0,1,1671.0,
030317021313,176594,2,0,2,1897.0,
030317021627,176811,0,0,0,2124.0,
030317021832,176888,4,1,5,,
030317021849,176889,0,8,8,253.98,
030317022105,177093,3,2,5,69.98,
030317022112,177094,0,0,0,69.98,
030317022129,177095,0,0,0,69.98,
030317022136,177096,0,1,1,69.98,
030317022457,177228,6,10,16,444.0,
030317022648,177332,0,2,2,2124.0,
030317023034,177597,3,0,3,739.0,
030317023027,177598,0,1,1,739.0,
030317023010,177599,1,2,3,591.0,
030317023003,177600,1,0,1,591.0,
030317023751,177910,0,0,0,222.0,
030317023867,178027-LEU,0,0,0,887.0,
030317023928,178121,0,0,0,28.98,
030317023911,178127,0,1,1,28.98,
030317024024,178166,0,1,1,1404.0,
030317026028,179292,12,4,16,1773.0,
030317026042,179293,0,0,0,1773.0,1733.0
030317026035,179294,0,0,0,1625.0,
030317026288,179570,1,2,3,296.0,
030317026301,179585,5,0,5,454.0,
030317026295,179586,1,31,32,454.0,379.0
030317026745,180092,0,1,1,222.0,
030317026721,180093,14,0,14,,
030317026820,180143,0,0,0,296.0,
030317026837,180144,2,1,3,370.0,
030317026882,180222,0,1,1,1671.0,
030317026899,180223,1,0,1,1820.0,
030317027650,180380,5,4,9,287.0,
030317028336,180590,5,0,5,222.0,
030317028411,180592,0,1,1,222.0,
030317028558,180600,0,0,0,259.0,
030317028497,180601,0,0,0,296.0,
030317028459,180602,14,0,14,296.0,
030317028374,180603,35,0,35,259.0,
030317028381,180609,0,0,0,1671.0,
030317028466,180613,2,0,2,259.0,
030317028428,180615,5,5,10,370.0,
030317028541,180616,4,9,13,370.0,
030317028350,180617,26,31,57,,
030317028534,180618,8,3,11,444.0,
030317028404,180619,2,16,18,444.0,
030317028367,180620,19,14,33,517.0,
030317028435,180621,18,21,39,591.0,
030317028572,180622,0,0,0,517.0,
030317028596,180623,25,25,50,554.0,
030317028442,180626,5,2,7,517.0,
030317028503,180627,7,4,11,517.0,
030317028510,180628,24,29,53,591.0,
030317028589,180629,0,8,8,665.0,
030317028718,180662,0,0,0,517.0,
030317028619,180665,0,0,0,370.0,
030317028732,180666,0,0,0,517.0,
030317028763,180668,0,0,0,517.0,
030317028602,180669,0,0,0,444.0,
030317028725,180670,0,0,0,370.0,365.0
030317028794,180726,0,0,0,1518.0,
030317029159,181105,4,4,8,,
030317029166,181106,0,0,0,349.0,
030317029425,181172,4,2,6,138.0,
030317029494,181173,0,0,0,148.0,145.0
030317029500,181174,3,0,3,159.0,
030317029463,181175,1,1,2,169.0,
030317029432,181176,2,1,3,170.0,
030317029456,181177,1,2,3,185.0,
030317029524,181178,2,2,4,200.0,
030317029449,181179,2,0,2,215.0,
030317029784,181307,26,86,112,222.0,
030317032067,182352,0,0,0,1182.0,
030317032104,182402,1,2,3,111.0,
030317032197,182417,5,3,8,67.0,
030317032203,182418,3,3,6,73.0,
030317032340,182444,13,12,25,370.0,
030317034610,182883,0,0,0,1182.0,
030317036713,183727,0,0,0,148.0,
030317487621,48762,1,1,2,9.0,
030317488079,48807,0,0,0,9.0,
030317498412,49841,1,9,10,20.98,
030317498986,49898,1,1,2,21.98,
030317499006,49900,0,1,1,21.98,
030317499013,49901,0,0,0,21.98,
030317499037,49903,2,4,6,21.98,
030317499044,49904,0,0,0,21.98,
030317499112,49911,0,1,1,33.98,
030317499136,49913,0,0,0,33.98,
030317499563,49956,0,0,0,33.98,
030317499594,49959,0,0,0,33.98,
030317499600,49960,0,0,0,33.98,
030317499617,49961,0,9,9,33.98,
030317499853,49985,0,1,1,28.98,
030317499860,49986,0,4,4,28.98,
030317499877,49987,3,2,5,28.98,
030317499969,49996,0,1,1,28.98,
030317500016,50001,9,4,13,28.98,
030317500030,50003,12,4,16,28.98,
030317500047,50004,0,3,3,28.98,
030317500054,50005,0,3,3,28.98,
030317500061,50006,1,3,4,28.98,
030317500078,50007,3,3,6,28.98,
030317500160,50016,8,19,27,20.98,
030317500184,50018,6,6,12,20.98,
030317500238,50023,0,2,2,20.98,
030317500283,50028,5,5,10,20.98,
030317500429,50042,0,10,10,22.98,
030317500443,50044-LEU,5,4,9,22.98,
030317502379,50237,5,8,13,20.98,
030317510336,51033,0,7,7,33.98,
030317510343,51034,5,6,11,47.98,
030317510350,51035,0,0,0,47.98,
030317517014,51701,0,3,3,20.98,
030317522964,52296,0,2,2,14.0,
030317544478,54447,0,0,0,20.98,
030317557423,55742,0,0,0,20.98,
030317558505,55850,17,7,24,12.0,8.98
030317558604,55860,0,50,50,15.98,
030317558703,55870,0,0,0,15.98,
030317558802,55880,0,4,4,15.98,
030317558901,55890,1,4,5,9.0,
030317559007,55900,17,12,29,9.0,
030317559106,55910,0,1,1,9.0,
030317565060,56506,2,3,5,9.0,
030317565091,56509,9,0,9,9.0,
030317565121,56512,0,1,1,9.0,
030317565244,56524,0,0,0,15.98,
030317565336,56533,0,2,2,15.98,
030317573850,57385,11,14,25,15.98,14.0
030317578336,57833,5,2,7,15.98,
030317586805,58680,0,4,4,222.0,
030317587505,58750,0,0,0,333.0,
030317592202,59220,5,6,11,71.0,
030317592257,59225,8,0,8,78.0,
030317592301,59230,11,0,11,30.98,
030317592400,59240,1,4,5,30.98,
030317592455,59245,0,2,2,30.98,
030317593100,59310,11,6,17,111.98,
030317593209,59320,0,0,0,111.98,
030317600402,60040-LEU,2,0,2,1499.0,
030317606992,60699,9,6,15,99.98,
030317607500,60750,0,19,19,99.98,
030317610494,61049,2,2,4,99.98,
030317654160,65416,1,0,1,20.98,
030317024949,178745,99,57,156,296.0,200.0
030317029029,180947,0,41,41,34.0,
028634704897,SWPENMP2BK,32,16,48,,
028634702961,SWPENMPBK,28,17,45,,
028634708604,SWMP11B,53,17,70,,
028634709250,SWMP13BS,53,30,83,,
028634701070,SWMP1BS,13,6,19,,
028634702565,SWMP4LS,40,13,53,,
028634709540,SWMPF3BR,42,11,53,,
661120651161,1182988,5,24,29,,
661120265726,1160824,6,26,32,,
661120413974,1085898,18,22,40,,
661120076261,1100078,45,20,65,,
661120106807,1147102,62,36,98,,
661120413691,1084314,75,78,153,,
661120413707,1084315,64,72,136,,
661120413769,1084321,32,19,51,,
661120748014,1200647,0,0,0,,
858003000103,LU10B,99,48,147,17.99,
858003000127,LU12B,17,6,23,18.99,
858003000219,LU21B,15,7,22,21.99,
858003000301,LU30B,20,26,46,25.99,
858003000349,LU34B,10,3,13,25.99,
858003000608,UP60B,99,99,198,22.99,
811619021009,UP60P,99,92,191,22.99,
811619021078,UP60US,99,99,198,22.99,
858003000622,UP62B,62,32,94,24.99,22.99
858003000646,UP64B,46,45,91,23.99,
811619021016,UP64P,27,23,50,23.99,
858003000653,UP65G,12,0,12,11.99,
761226090229,BFR30-30-6,0,0,0,1099.99,
761226090212,BFR30-307-6,0,0,0,1099.99,
761226089933,BFR350L10,0,0,0,1099.99,
761226089926,BFR350L7,0,0,0,1099.99,
761226089841,BFR357MAG7-6,0,0,0,1099.99,
761226089858,BFR44MAG7-6,0,0,0,1099.99,
761226028529,BFR45/70,0,0,0,1099.99,
761226028635,BFR45/707,0,0,0,1099.99,
761226086208,DE1911C,0,0,0,769.99,
761226087267,DE1911CSS,0,0,0,814.99,
761226085959,DE1911G,0,0,0,769.99,
761226089834,DE1911G10,0,0,0,799.99,
761226087137,DE1911GSS,0,0,0,814.99,
761226090281,DE1911UTT,0,0,0,914.99,
761226022831,DE357,0,0,0,1509.99,
761226024217,DE357BC,0,0,0,1769.99,
761226087694,DE357L5IMB,0,0,0,1759.99,
761226022756,DE44,0,0,0,1509.99,
761226088110,DE44ASIMB,0,0,0,2019.99,
761226086987,DE44BB,0,0,0,1589.99,
761226024132,DE44BC,0,0,0,1809.99,
761226032281,DE44CA,0,0,0,1569.99,
761226087328,DE44CABB,0,0,0,1589.99,
761226085027,DE44CABC,0,0,0,1859.99,
761226088400,DE44CH,0,0,0,2499.99,
761226087212,DE44IMB,0,0,0,1579.99,
761226087700,DE44L5IMB,0,0,0,1759.99,
761226087922,DE44SRMB,0,0,0,1909.99,
761226022350,DE50,0,0,0,1539.99,
761226087946,DE50ASIMB,0,0,0,2019.99,
761226023074,DE50BC,0,0,0,1839.99,
761226090397,DE50BKC,0,0,0,1589.99,
761226088028,DE50BTS,0,0,0,2009.99,
761226088394,DE50CH,0,0,0,2579.99,
761226087205,DE50IMB,0,0,0,1609.99,
761226087717,DE50L5IMB,0,0,0,1759.99,
761226090434,DE50L5VK,0,0,0,2424.99,
761226022985,DE50PC,0,0,0,1979.99,
761226087199,DE50SRMB,0,0,0,1909.99,
761226029885,DE50TG,0,0,0,2499.99,
761226037927,DE50TG-TS,0,0,0,2629.99,
761226088387,DE50WB6,0,0,0,1929.99,
761226088042,DE50WMD,0,0,0,1839.99,
761220835802,MLR22WMH,0,0,0,789.99,
761226084631,MLRS22WMH,0,0,0,789.99,
761226089049,SSAT22G,9,0,9,634.99,
761226089865,MAG1911-108,0,0,0,23.99,
761226086086,MAG1911-458,0,0,0,23.99,
761226022923,MAG357,6,5,11,40.99,
761226022916,MAG44,0,0,0,40.99,
761226022909,MAG50,0,0,0,40.99,
761226087335,BMCP506,0,0,0,444.99,
761226086864,BE94133RL,39,30,69,579.99,
761226086871,BE94133RSL,51,0,51,579.99,
761226086789,BE99153R,47,8,55,664.99,
761226086840,BE99153RL,17,21,38,579.99,
761226086796,BE99153RS,31,0,31,664.99,
761226086857,BE99153RSL,58,0,58,579.99,499.99
761226087083,DE50SR,0,0,0,1789.99,
736676704507,70450-RUG,0,0,0,963.0,
736676704569,70456-RUG,0,0,0,819.0,
736676704781,70478,0,0,0,977.0,
689585855757,4010101,4,8,12,209.99,
689585855931,4010103,20,17,37,224.99,
689585855948,4010104,16,16,32,224.99,
713440971105,4110602,2,2,4,264.99,
713440971112,4110603,2,0,2,264.99,
713440971129,4110604,33,8,41,264.99,
689585855986,4110605,0,0,0,,
689585855924,4110606,93,0,93,334.99,
689585855917,4110607,99,76,175,309.99,
713440971051,4070024,19,0,19,329.99,
689585855221,4070025,50,23,73,354.99,
689585855214,4070026,2,5,7,374.99,
713440971006,4150014,21,0,21,329.99,
689585854569,4150018,27,20,47,354.99,
689585855801,4150024,8,3,11,354.99,
689585855818,4150025,0,4,4,374.99,
713440971075,4400009,0,3,3,364.99,
713440970948,4440011,5,7,12,389.99,
713440971068,4070002,0,0,0,32.99,
713440971136,4110013,0,0,0,24.99,
713440971020,4150019,0,0,0,33.99,
689585855207,4150104,0,0,0,74.99,
713440971082,4400013,0,0,0,32.99,
713440970962,4440016,0,0,0,33.99,
4250892219585,41200401,5,2,7,,
713440970894,19500007,8,7,15,284.99,
713440970887,19500107,7,6,13,284.99,
713440970993,4150013,99,0,99,329.99,
049533310088,31008,0,0,0,214.99,
049533310101,31010,0,0,0,214.99,
049533310125,31012,0,0,0,239.99,
049533310149,31014,0,0,0,239.99,
049533310170,31017,8,0,8,214.99,
049533310224,31022,0,0,0,224.99,
049533310231,31023,0,0,0,214.99,
049533310279,31027,0,0,0,239.99,
049533310446,31044,16,0,16,239.99,
049533310460,31046,0,0,0,214.99,
049533310484,31048,0,0,0,224.99,
049533310804,31080-MAV,0,0,0,214.99,
049533322005,32200,0,0,0,214.99,
049533322012,32201,0,0,0,239.99,
049533322029,32202,0,0,0,214.99,
049533322036,32203,0,0,0,239.99,
049533322043,32204,0,0,0,214.99,
814002027701,10EXD762X51,47,5,52,13.99,12.99
814002027718,10EXD762X51-SDE,20,18,38,,
676315033615,10PM556BAG-BL,99,10,109,7.99,
814002027688,20EXD762X51,99,0,99,14.99,13.99
814002027695,20EXD762X51-SDE,0,0,0,14.99,13.99
814002022935,EXDPM556-BL,99,99,198,8.99,
814002022942,EXDPM556-SDE,49,15,64,8.99,8.49
814002024694,EXDPM556-W-BL,0,0,0,10.49,9.99
814002025783,EXDPM556-W-SDE,29,24,53,10.49,9.99
814002024724,EXDPM556D-AFM1,0,0,0,13.99,12.99
810099431551,EXDPM556D-NG,99,99,198,13.99,12.99
810099431575,EXDPM556D-PLM,66,59,125,13.99,11.49
814002024861,EXDPM556D-PSSWH,42,0,42,13.99,12.99
810099431605,EXDPM556D-TRKP,99,99,198,13.99,11.49
810099431582,EXDPM556D-TRP,96,89,185,13.99,11.49
814002024915,EXDPM556D-TXSF,0,25,25,13.99,12.99
810099431599,EXDPM556D-VHS,99,99,198,13.99,11.49
676315033561,SCPM556BAG-BL,0,0,0,7.99,
676315033608,SCPM556BAG-SDE,46,0,46,7.99,
810099431810,BM-7,0,0,0,22.99,22.99
676315025856,BMSMIL-BL,24,3,27,34.99,
814002026650,BMSMIL-MTL-BL,0,0,0,104.99,99.99
676315028727,BMSMIL-SDE,4,2,6,34.99,
810099431698,BUEXD-R,0,0,0,74.99,74.99
810099431704,BUEXD-F,0,0,0,67.99,67.99
676315033103,BUPSWF-BL,13,6,19,20.99,
676315033127,BUPSWR-BL,25,8,33,24.99,
814002020641,E2AREMR,3,1,4,14.99,
810099430448,E2AREPDC-AMF,0,4,4,8.99,8.99
814002020160,E2ARETG-BL,5,0,5,5.99,
814002021082,E2ARMD1,5,7,12,25.99,
814002021136,E2ARMD4,0,1,1,59.99,
814002020887,E2BPM-BL,1,0,1,19.99,
676315033868,E2LPGB-BL,5,0,5,21.99,
814002020207,EPG16V2-BL,2,6,8,11.99,
814002020665,EPG27-BL,77,0,77,11.99,
814002023031,H2GL43AIWBM,6,0,6,19.99,
814002023024,H2GL940AIWBM,7,3,10,19.99,
814002027107,H2RUMX9AIWBM,2,2,4,19.99,
814002027626,H2SFHCAIWBM,1,1,2,19.99,
814002023000,H2SG365AIWBM,3,5,8,19.99,
814002023017,H2SWSHAIWBM,0,6,6,19.99,
814002028869,H2TGX4AIWBM,4,1,5,19.99,
810099433685,H3-GL-1-BLK2,0,4,4,41.99,
814002027374,H3-GL-1-BR1,5,2,7,41.99,
810099433692,H3-GL-3-BLK2,0,0,0,41.99,
814002027381,H3-GL-3-BR1,8,1,9,41.99,
810099433708,H3-SAW-1-BLK2,5,4,9,41.99,
814002027411,H3-SAW-1-BR1,2,2,4,41.99,39.99
810099432688,H3-SFD-5-BR1,0,0,0,41.99,
810099433722,H3-SFD-1-BLK2,11,5,16,41.99,
814002027459,H3-SFD-1-BR1,2,3,5,41.99,39.99
810099433739,H3-SFD-3-BLK2,0,0,0,41.99,
810099432671,H3-SFD-3-BR1,0,0,0,41.99,39.99
810099433715,H3-SIG-1-BLK2,6,2,8,41.99,
814002027442,H3-SIG-1-BR1,5,2,7,,
810099433784,H4-GL-2-BLK2,3,2,5,48.99,
814002027473,H4-GL-2-BR1,10,5,15,48.99,
810099433791,H4-SFD-2-BLK2,3,2,5,48.99,
814002027565,H4-SFD-2-BR1,2,2,4,48.99,
810094338077,H4-SFD-4-BLK2,0,0,0,,
810099432718,H4-SFD-4-BR1,0,0,0,48.99,
810099433814,H4-SFD-6-BLK2,0,0,0,48.99,
810099432725,H4-SFD-6-BR1,0,0,0,48.99,
810099433821,H4-SIG-2-BLK2,0,2,2,48.99,
814002027572,H4-SIG-2-BR1,5,3,8,48.99,
810099431742,H5-GL-1-WL-1,0,0,0,54.99,52.99
810099431780,H5-GL-1-WL-7,0,0,0,54.99,52.99
810099431759,H5-GL-3-WL-7,0,0,0,54.99,
810099431773,H5-SFD-1-WL-6,0,0,0,54.99,52.99
810099431766,H5-SIG-1-WL-7,0,0,0,54.99,
810099431735,H6-BB-1,0,0,0,31.99,
810099432756,H8-GL-1,0,0,0,54.99,
810099432763,H8-GL-3,0,0,0,54.99,52.99
810099432787,H8-SFD-2,0,0,0,54.99,52.99
810099432770,H8-SIG-1,0,0,0,54.99,52.99
814002020900,HGL17OWB-BL,3,2,5,34.99,32.99
814002022126,HGL19AIWBA-BL,13,0,13,32.99,
814002021211,HGL19OWB-BL,2,2,4,34.99,
814002021242,HGL43OWB-BL,5,0,5,34.99,
814002023338,HPD1R,10,3,13,5.99,
814002028807,HRUMX9AIWBA-BL,4,0,4,32.99,29.99
810099433746,H3-SFD-5-BLK2,0,0,0,41.99,
810099432800,HSF1911-DSFAIWB,6,5,11,32.99,29.99
810099432794,HSF1911-DSAIWBA,9,1,10,32.99,
814002025998,HSFHCAIWBA-BL,2,0,2,32.99,
814002022157,HSGL43AIWBA-BL,9,0,9,32.99,
814002021983,HSIG320FSOWB-BL,3,2,5,34.99,32.99
810099432817,HSIG365MAIWBA-B,0,0,0,32.99,29.99
814002022775,HSIG365AIWBA-BL,10,1,11,32.99,
814002022782,HSIG365OWB-BL,5,3,8,34.99,
814002022799,HSWMP20AIWBA-BL,0,0,0,32.99,
814002026384,HSWSH-EZ9AIWBA,5,3,8,32.99,
814002022317,HSWSHSAIWBA-BL,4,0,4,32.99,
814002028876,HTGX4AIWBA-BL,0,0,0,,
814002022362,HTPT111SAIWB-BL,10,2,12,32.99,
676315009047,OPSM,8,10,18,19.99,
814002028319,RCG-MLOK,14,0,14,13.99,12.99
676315024897,REG-BL,0,0,0,14.99,
676315024903,RFG-BL,0,0,0,22.99,
676315024927,RMG-BL,0,0,0,16.99,
676315024880,RSG-BL,17,0,17,14.99,
676315032946,TBLW-BL,10,5,15,30.99,
676315029014,TMARCIRS,0,9,9,75.99,
810099430271,TMEXD-MHG-10,2,4,6,89.99,84.99
810099430264,TMEXD-MHG-135,9,5,14,104.99,99.99
810099430257,TMEXD-MHG-15,7,5,12,114.99,109.99
676315033974,TMKMR3,30,0,30,14.99,
814002022546,TMMLR5,18,1,19,14.99,
814002024335,BMSMIL-EXD-BL,19,0,19,39.99,19.99
814002020702,TP15MRS-BL,21,0,21,22.99,
015813890250,89025,0,0,0,406.99,
015813890441,89044,0,0,0,479.99,
015813277075,27707,0,0,0,494.99,
015813277167,27716,0,0,0,494.99,
015813277389,27738,0,0,0,494.99,
015813277785,27778,0,0,0,519.99,
015813277938,27793,0,0,0,644.99,
015813278355,27835,0,1,1,489.99,
015813278386,27838,3,0,3,344.99,
015813278409,27840,5,31,36,374.99,
015813278416,27841,0,0,0,489.99,
015813278430,27843,0,0,0,344.99,
015813278492,27849,0,0,0,489.99,
015813278515,27851,10,2,12,344.99,
015813278539,27853,45,0,45,374.99,
015813278614,27861,0,0,0,489.99,
015813278645,27864,0,0,0,344.99,
015813278676,27867,0,0,0,374.99,
015813278744,27874-MOS,23,0,23,394.99,
015813278751,27875,35,0,35,394.99,
015813278768,27876,0,0,0,489.99,
015813278775,27877,0,0,0,344.99,
015813278829,27882,0,0,0,489.99,
015813278843,27884,12,0,12,344.99,
015813278928,27892,0,0,0,344.99,
015813279093,27909,4,4,8,344.99,
015813279246,27924,0,0,0,704.99,
015813279321,27932,3,0,3,459.99,
015813279338,27933,0,13,13,459.99,
015813279345,27934,0,13,13,459.99,
015813279352,27935,14,17,31,459.99,
015813279390,27939,0,0,0,614.99,
015813279406,27940,0,3,3,614.99,
015813279413,27941,0,0,0,614.99,
015813279420,27942,0,0,0,614.99,
015813280013,28001,7,12,19,459.99,
015813280051,28005,0,0,0,389.99,
015813280075,28007-MOS,0,6,6,389.99,
015813280082,28008,1,4,5,389.99,
015813280099,28009-MOS,0,0,0,389.99,
015813280105,28010,0,0,0,389.99,
015813280136,28013,0,0,0,354.99,
015813280198,28019,9,15,24,704.99,
015813280433,28043,0,0,0,489.99,
015813280440,28044,0,0,0,464.99,
015813280457,28045,0,0,0,464.99,
015813280464,28046,0,0,0,464.99,
015813280488,28048,0,0,0,419.99,
015813280495,28049-MOS,0,0,0,419.99,
015813280501,28050,0,0,0,419.99,
015813280525,28052,0,0,0,459.99,
015813280532,28053-MOS,5,1,6,459.99,
015813280549,28054,0,0,0,459.99,
015813280570,28057-MOS,0,0,0,614.99,
015813280587,28058,0,0,0,614.99,
015813280594,28059-MOS,0,0,0,614.99,
015813280655,28065,0,0,0,419.99,
015813280662,28066,0,0,0,419.99,
015813280679,28067,23,0,23,419.99,
015813280686,28068,0,0,0,389.99,
015813280747,28074,0,0,0,464.99,
015813280853,28085,0,0,0,344.99,
015813280907,28090,25,13,38,394.99,
015813280914,28091,8,0,8,464.99,
015813280945,28094,0,0,0,374.99,
015813281010,28101,0,0,0,614.99,
015813281027,28102,10,0,10,614.99,
015813281034,28103,27,15,42,614.99,
015813281041,28104,14,0,14,614.99,
015813281133,28113,0,0,0,529.99,
015813281140,28114,0,0,0,529.99,
015813281157,28115,1,0,1,529.99,
015813281164,28116,0,0,0,529.99,
015813281171,28117,0,0,0,529.99,
015813281188,28118,12,0,12,354.99,
015813281225,28122,0,0,0,704.99,
015813281232,28123,0,0,0,474.99,
015813281249,28124,0,0,0,629.99,
015813281256,28125,0,0,0,474.99,
015813281270,28127,0,0,0,629.99,
015813281294,28129,0,0,0,404.99,
015813281300,28130,0,0,0,499.99,
015813281317,28131,8,14,22,354.99,
015813281324,28132,0,0,0,499.99,
015813281355,28135,0,0,0,404.99,
015813281362,28136,0,0,0,419.99,
015813281379,28137,0,0,0,489.99,
015813281423,28142,4,4,8,419.99,
015813281430,28143,0,0,0,419.99,
015813281447,28144,0,5,5,419.99,
015813281454,28145,13,7,20,419.99,
015813281478,28147,0,0,0,789.99,
015813281485,28148,0,0,0,789.99,
015813281492,28149,0,0,0,789.99,
015813281706,28170,8,18,26,394.99,
015813281713,28171,10,19,29,464.99,
015813501040,50104,0,0,0,369.99,
015813501125,50112,0,0,0,369.99,
015813501200,50120,0,0,0,369.99,
015813501217,50121,42,27,69,429.99,
015813501361,50136,0,0,0,369.99,
015813502054,50205,37,0,37,479.99,
015813502061,50206,23,0,23,544.99,
015813502085,50208,0,0,0,479.99,
015813502993,50299,0,0,0,609.99,
015813503556,50355,0,0,0,414.99,
015813503587,50358,0,0,0,369.99,
015813503648,50364,0,3,3,414.99,
015813504249,50424,0,0,0,544.99,
015813504294,50429,42,24,66,444.99,
015813504317,50431,0,6,6,574.99,
015813504850,50485,19,0,19,369.99,
015813504973,50497,0,0,0,414.99,
015813504997,50499,0,0,0,414.99,
015813506359,50635,0,0,0,769.99,
015813506380,50638,73,23,96,519.99,
015813506397,50639,0,0,0,404.99,
015813506472,50647,99,98,197,489.99,
015813506489,50648,0,0,0,489.99,
015813506496,50649,0,0,0,404.99,
015813506519,50651,0,0,0,509.99,
015813506533,50653,3,8,11,444.99,
015813506564,50656,67,28,95,564.99,
015813506571,50657,99,24,123,404.99,
015813506595,50659,0,0,0,404.99,
015813506731,50673,0,0,0,509.99,
015813506748,50674,0,0,0,484.99,
015813506755,50675,85,60,145,509.99,
015813506915,50691,20,0,20,524.99,
015813506922,50692,16,10,26,479.99,
015813506939,50693,0,0,0,434.99,
015813506946,50694,24,3,27,419.99,
015813506953,50695,6,14,20,524.99,
015813506960,50696,21,8,29,639.99,
015813506977,50697,2,0,2,404.99,
015813506984,50698,19,1,20,404.99,
015813507004,50700,0,0,0,404.99,
015813507653,50765,0,0,0,569.99,
015813507660,50766,0,0,0,529.99,
015813507677,50767,0,0,0,659.99,
015813507684,50768,0,0,0,594.99,
015813507691,50769,0,0,0,769.99,
015813507714,50771,0,0,0,789.99,
015813507783,50778,0,0,0,404.99,
015813507806,50780,0,99,99,349.99,
015813513401,51340,45,0,45,439.99,
015813514828,51482,99,23,122,369.99,
015813516006,51600,99,82,181,484.99,
015813516013,51601,99,99,198,484.99,
015813516020,51602,0,0,0,564.99,
015813516044,51604,0,0,0,509.99,
015813516051,51605,0,0,0,509.99,
015813516600,51660,0,0,0,594.99,
015813516631,51663,0,0,0,624.99,
015813516655,51665,0,0,0,789.99,
015813516686,51668,6,0,6,674.99,
015813516723,51672,0,9,9,589.99,
015813517737,51773,0,0,0,709.99,
015813521321,52132,7,8,15,369.99,
015813521451,52145,0,0,0,484.99,
015813521499,52149,0,0,0,769.99,
015813521505,52150,0,0,0,489.99,
015813521512,52151,0,0,0,474.99,
015813522809,52280,5,0,5,439.99,
015813523400,52340,0,0,0,564.99,
015813540476,54047,0,0,0,399.99,
015813541329,54132,17,0,17,369.99,
015813541572,54157,0,0,0,424.99,
015813541619,54161,0,0,0,414.99,
015813541695,54169,0,0,0,409.99,
015813541831,54183-MOS,16,0,16,474.99,
015813541886,54188,3,0,3,419.99,
015813542104,54210,21,21,42,369.99,
015813542159,54215,0,0,0,474.99,
015813542180,54218-MOS,0,0,0,424.99,
015813542432,54243,0,0,0,444.99,
015813542500,54250,0,0,0,419.99,
015813542647,54264,0,0,0,419.99,
015813542821,54282,0,0,0,419.99,
015813543309,54330,0,0,0,464.99,
015813564205,56420,53,0,53,369.99,
015813564366,56436,24,4,28,369.99,
015813571104,57110,0,0,0,369.99,
015813571203,57120,0,0,0,369.99,
015813573405,57340,9,14,23,444.99,
015813582445,58244,6,0,6,399.99,
015813624190,62419,10,0,10,499.99,
015813624374,62437,17,1,18,499.99,
015813631020,63102,30,0,30,569.99,549.99
015813635219,63521,0,0,0,454.99,
015813635271,63527,11,21,32,454.99,
015813682244,68224,10,0,10,429.99,
015813810005,81000,16,1,17,589.99,
015813810234,81023,16,4,20,644.99,
015813810463,81046-MOS,36,0,36,669.99,609.99
015813820424,82042,0,0,0,774.99,
015813851114,85111,0,0,0,869.99,
015813851138,85113,9,0,9,869.99,
015813851435,85143,0,20,20,869.99,
015813851503,85150,0,0,0,899.99,
015813851510,85151,0,0,0,849.99,
015813851527,85152,0,0,0,869.99,
015813851558,85155,80,21,101,699.99,
015813851565,85156,85,0,85,869.99,849.99
015813851589,85158,36,0,36,869.99,849.99
015813851619,85161,0,0,0,964.99,
015813852234,85223,17,17,34,924.99,
015813852326,85232,0,0,0,599.99,
015813853705,85370,0,2,2,869.99,
015813951357,95135,15,29,44,29.99,
015813951364,95136,0,0,0,29.99,
015813951371,95137,7,11,18,72.99,
015813951388,95138,7,15,22,82.99,
015813951395,95139,0,16,16,97.99,
015813951401,95140,3,0,3,104.99,
015813960106,96010,7,3,10,159.99,
015813890120,89012,0,14,14,369.99,
015813890168,89016,34,30,64,449.99,
015813890175,89017,16,0,16,449.99,
015813890182,89018,0,5,5,369.99,
015813890199,89019,0,1,1,369.99,
015813890205,89020,5,9,14,369.99,
015813890212,89021,13,0,13,369.99,
015813852227,85222,11,0,11,539.99,499.99
015813280112,28011,0,0,0,389.99,
015813280624,28062,0,0,0,389.99,
015813281287,28128,0,0,0,559.99,
015813503594,50359,0,0,0,369.99,
015813516037,51603,0,23,23,499.99,
015813556071,55607,0,0,0,429.99,
015813851107,85110,2,0,2,599.99,
015813853606,85360,0,1,1,754.99,
884110372512,37251,0,0,0,239.99,
884110370716,37071,84,14,98,169.99,
884110370723,37072,73,0,73,144.99,
884110370730,37073,26,0,26,179.99,
884110372055,37205,0,0,0,294.99,
884110372321,37232,0,0,0,334.99,
884110372345,37234,0,0,0,334.99,
884110372406,37240,0,0,0,334.99,
884110381910,38191,58,21,79,194.99,
884110382306,38230,2,25,27,169.99,
884110382320,38232,0,0,0,179.99,
884110754707,75470,0,0,0,549.99,
884110754714,75471,0,0,0,594.99,
884110754721,75472,12,2,14,824.99,
884110754738,75473,7,0,7,824.99,
884110754745,75474,0,0,0,1024.99,
884110754752,75475,0,0,0,594.99,
884110754776,75477,0,1,1,594.99,
884110754783,75478,2,3,5,594.99,
884110754790,75479,4,5,9,594.99,
884110754806,75480,6,3,9,824.99,
884110757692,75769,0,0,0,524.99,
884110757708,75770,37,65,102,524.99,
884110757715,75771,99,99,198,524.99,
884110757722,75772,89,4,93,524.99,
884110757807,75780,42,0,42,529.99,
884110757890,75789,83,0,83,604.99,
884110757937,75793,3,2,5,604.99,
884110757951,75795,24,9,33,654.99,
884110757999,75799,0,0,0,649.99,
884110758019,75801,4,0,4,589.99,
884110758026,75802,6,0,6,649.99,
884110957023,95702,0,0,0,24.99,
884110957122,95712,0,0,0,28.99,
884110957252,95725,0,0,0,27.99,
884110958037,95803,0,0,0,24.99,
884110958877,95887,0,0,0,24.99,
884110754769,75476,30,9,39,779.99,
814108017590,A12SH46,10,10,20,12.99,
814108017385,AARFVG,0,0,0,9.49,
848754005588,AASWQRB,0,0,0,2.99,
814108011802,MAR4S,0,0,0,,
814108014094,MARDCH,15,34,49,32.99,30.2
814108014070,MARFLF,0,10,10,12.99,
814108019808,MARFLF2,0,4,4,12.99,
814108014087,MARFLR,0,0,0,16.99,
814108019389,MPR45,0,0,0,8.99,
814108012939,TARW,0,0,0,15.49,
848754000095,TARW2,0,0,0,22.99,
848754007445,VAML1CB,0,10,10,5.99,
848754003195,VMKM3,0,0,0,7.99,
848754003188,VMKM6,0,41,41,9.49,
848754003560,VMML3,0,0,0,7.99,
848754003577,VMML6,0,0,0,9.49,
848754010230,VTARUVB,0,8,8,27.99,
848754009746,VTGLK5,2,3,5,12.99,
848754007483,VTGLKPBL,5,9,14,10.99,
848754011480,VTGLPRO,0,0,0,9.99,
848754011497,VTUFNR,0,0,0,65.99,
848754005335,VTUPRS,0,0,0,44.99,
814108011260,D4B,0,0,0,32.99,
814108018085,DRGB135,0,0,0,44.99,
848754001405,SECXRSM2732,0,5,5,79.99,
848754000583,STM3942GDV2,0,0,0,89.99,
848754012050,VDBSOLC,0,5,5,89.99,
848754012043,VDFLIPPRO,0,0,0,76.99,
814108012991,AAKC,0,0,0,7.49,
017398807371,LGC-550XL,0,1,1,,
017398807609,LGL-150,0,11,11,78.0,
017398807630,LGL-KM1,14,17,31,,
017398807647,LGL-ML1,27,9,36,,
017398803670,TAC-560XL,4,3,7,71.3,
017398807661,TSM-13G,0,99,99,77.0,47.0
017398807906,TSM-14G,6,15,21,77.0,47.0
017398807913,TSM-15G,99,86,185,77.0,57.0
017398807869,TSM-16G,78,99,177,77.0,
017398805421,TWM-350,44,65,109,65.5,45.5
017398807128,USB-578XL,0,12,12,,
744253002380,NAA-1860-250,0,0,0,279.99,
744253002397,NAA-1860-250C,0,0,0,339.99,
744253001994,NAA-1860-4C,0,0,0,339.99,
744253000010,NAA-22LLR,0,0,0,209.99,
744253000478,NAA-22LLR-HG,0,0,0,237.99,
744253000034,NAA-22LR,0,0,0,209.99,
744253003004,NAA-22LR-CRK,0,14,14,274.99,
744253000492,NAA-22LR-HG,0,0,0,237.99,
744253000133,NAA-22M,0,0,0,219.99,
744253003189,NAA-22M-BTIIB,0,0,0,439.99,
744253000904,NAA-22M-HG,0,0,0,249.99,
744253003264,NAA-22M-R,0,0,0,434.99,
744253003288,NAA-22M-R250,1,0,1,469.99,
744253002298,NAA-22M-TW,8,0,8,249.99,
744253003196,NAA-22MBTII250B,0,0,0,469.99,
744253000188,NAA-22MC,0,0,0,279.99,
744253000911,NAA-22MC-HG,0,0,0,309.99,
744253003271,NAA-22MC-R,0,0,0,519.99,
744253003295,NAA-22MC-R250,0,0,0,559.99,
744253002304,NAA-22MC-TW,0,0,0,309.99,
744253000218,NAA-22MS,0,0,0,219.99,
744253003561,NAA-22MS-CRK,96,85,181,289.99,
744253000928,NAA-22MS-HG,0,0,0,249.99,
744253003509,NAA-22MS-VL,66,27,93,324.99,
744253000232,NAA-22MSC,0,0,0,279.99,
744253003578,NAA-22MSC-CRK,68,0,68,349.99,
744253000935,NAA-22MSC-HG,0,0,0,309.99,
744253000836,NAA-32GUARDIAN,0,0,0,349.99,
744253000942,NAA-380GUARDIAN,0,0,0,409.99,
744253000393,NAA-BW-L,45,0,45,269.99,
744253000430,NAA-BW-M,0,0,0,269.99,
744253003592,NAA-BWC-CRK,0,7,7,359.99,
744253003585,NAA-BWM-CRK,0,0,0,304.99,
744253003493,NAA-BWM-VL,0,0,0,339.99,
744253003547,NAA-PUG-CRK,99,1,100,379.99,
744253001871,NAA-PUG-D,0,0,0,304.99,
744253002632,NAA-PUG-DP,0,0,0,324.99,
744253003301,NAA-PUG-DTQ-W,47,0,47,364.99,
744253001864,NAA-PUG-T,0,0,0,324.99,
744253002533,NAA-SW,0,0,0,324.99,
744253002694,NAA-SW-250,0,0,0,369.99,
744253002540,NAA-SWC,0,0,0,454.99,
744253002700,NAA-SWC-250,2,0,2,509.99,
744253052019,GHG-LC,0,2,2,,
744253051326,GHG-M,0,0,0,29.99,
744253003516,NAA-1860-IND,89,2,91,399.99,
744253003608,NAA-22M-TWE,37,0,37,349.99,
054041400213,40021,0,0,0,2085.0,
054041403214,40321,0,1,1,2085.0,
054041404211,40421,0,0,0,2085.0,
054041406215,40621,0,0,0,2085.0,
054041409216,40921,0,1,1,2085.0,
054041441483,42048,0,0,0,2898.0,
054041453486,45348,0,1,1,2898.0,
054041507486,50748,0,0,0,2830.0,
661120107347,1149100,27,16,43,,
661120107330,1149145,38,17,55,,
661120106920,1137133,37,10,47,,
661120106937,1137134,33,9,42,,
661120107507,1140755,37,5,42,,
661120107491,1140756,24,20,44,,
661120107378,1135986,20,43,63,,
661120106883,1135989,77,6,83,,
661120106890,1135990,38,15,53,,
661120106906,1135991,21,5,26,,
661120106913,1135992,57,35,92,,
661120650379,1166380,21,8,29,,
661120650386,1166381,14,19,33,,
661120265221,1171774,6,5,11,,
044356001069,194OT,0,7,7,,
044356001045,18OT,25,12,37,,
044356001083,33OT,0,38,38,,
044356001120,34OT,20,26,46,,
044356001113,8OT,0,3,3,,
661120653240,1188049,14,21,35,,
661120747956,1200625,0,0,0,,
661120747970,1200627,0,0,0,,
661120747994,1200629,0,0,0,,
706433762736,1574,4,27,31,,
706433762743,1598,7,2,9,145.0,
706433762729,1599,19,20,39,109.0,
706433762750,1601,5,8,13,142.0,
706433763122,1627,5,9,14,92.0,
706433762903,1628,4,7,11,109.0,
706433762927,1646,3,9,12,,
706433762910,1647,7,3,10,142.0,
706433763016,1677,19,17,36,99.0,
706433763368,1792,1,5,6,56.0,
706433763245,1799-OSS,20,20,40,108.0,
706433763375,1822,7,3,10,56.0,
706433763399,1835-OSS,7,9,16,31.0,
706433763412,1836,0,0,0,57.0,
706433763382,1981-OSS,3,2,5,59.0,
706433763337,1982,5,3,8,88.0,
706433763344,1984,4,3,7,87.0,
706433763351,1985,9,8,17,88.0,
070643376367,HX-QD762TI,0,0,0,,
706433762125,1577-OSS,0,0,0,,
706433763283,1788,0,0,0,,
706433763290,1820-OSS,0,0,0,,
706433763252,1997,0,0,0,,
706433763276,2032,0,0,0,,
706433763436,2138H,0,0,0,,
706433763443,2139H,0,0,0,,
706433763450,2140H,0,0,0,,
706433763467,2141H,0,0,0,,
706433763689,2368H,0,0,0,,
706433763559,2449,0,0,0,,
706433763566,2450,0,0,0,,
706433763580,2501,0,0,0,,
014895013182,FG-1000-645,25,12,37,116.99,
014895002100,FG-210,11,6,17,28.99,
014895223406,FG-223-645,0,3,3,,
014895007020,FG-241-100,3,0,3,9.99,8.99
014895000267,FG-246,15,0,15,21.99,
014895007457,FG-248-645C,0,8,8,14.99,
014895003497,FG-2715,0,1,1,,
014895003541,FG-2715-PD-B,0,4,4,,
014895316306,FG-316-3-NBBZ,0,0,0,,
014895003671,FG-367-HT,1,0,1,,
014895012871,FG-4016-AR,19,9,28,250.99,
014895007815,FG-40C-LRW,19,6,25,11.99,10.99
014895004104,FG-410,0,0,0,28.99,24.99
014895006108,FG-610,3,1,4,28.99,
014895005187,FG-701-25,0,4,4,,
014895005194,FG-701-30,0,0,0,,
014895005132,FG-701-40,0,58,58,,
014895005149,FG-701-45,0,71,71,,
014895005118,FG-701-9MM,0,0,0,,
014895007501,FG-750,1,13,14,,
014895007228,FG-857-100,0,0,0,10.49,9.49
014895004692,FG-901-556-9,6,3,9,,
014895012529,FG-901-945,18,20,38,69.99,54.99
014895009239,FG-918-100,42,46,88,,
014895009604,FG-919-100,0,8,8,,
014895000564,FG-RC-325,0,86,86,,
014895000571,FG-RC-330,19,99,118,,
014895000588,FG-RC-338,12,31,43,,
014895002216,FG-RC-341,17,5,22,,
014895000595,FG-RC-345,0,0,0,,
014895010938,FG-RC-3G1,4,3,7,23.99,
014895010860,FG-RC-SET1,0,0,0,71.99,
014895004241,IP-2TW-085,0,0,0,,
014895012888,IP-75C-085,0,0,0,12.99,11.99
014895004036,IP-904-085,0,0,0,,
014895005224,RW-3501-3,0,0,0,,
8052464213443,PSA3543,67,8,75,459.99,
8052464212965,PSA354,0,0,0,399.99,
8052464212972,SA73-084,0,0,0,399.99,
8052464213573,PSA4505,0,0,0,629.99,
8052464212934,PSA454,0,0,0,399.99,
8052464212941,SA73-081,0,0,0,399.99,
8052464214167,PSA5241,0,0,0,464.99,
8052464213467,PSA4567,0,4,4,469.99,
8052464214181,PSA5273,0,0,0,464.99,
8052464214204,PSA520X2,0,0,0,534.99,
8052464214075,PSA5021,0,0,0,434.99,
8052464213528,PSA454X2,0,0,0,479.99,
8052464214082,PSA5047,0,0,0,434.99,
8052464213535,PSA455X2,2,31,33,479.99,
8052464214099,PSA5066,0,0,0,434.99,
8052464214112,PSA511X2,0,0,0,499.99,
8052464214006,PSA359X2,0,0,0,459.99,
8052464214105,PSA5083,0,0,0,434.99,
8052464214129,PSA515X2,0,0,0,499.99,
8052464213849,PSA4586,99,66,165,639.99,
8052464213962,PSA3592,0,0,0,539.99,
8052464213450,PSA4550,0,0,0,539.99,
8052464213504,PCG1220,99,0,99,829.99,
850036821298,AK-0031-C,0,0,0,609.99,
850036821069,AK-0031-FT-P,0,0,0,639.99,
850036821304,POL-AK-S-CT,15,3,18,659.99,
850036821052,POL-AK-S-CT-W,0,0,0,679.99,
850036821250,POL-AK-S-FS-CTP,5,7,12,699.99,
850036821014,POL-AK-S-FT-P,4,0,4,679.99,
850036821021,POL-AK-S-FT-W,0,0,0,699.99,659.99
847313008299,POF-00829,20,20,40,28.0,
847313008312,POF-00831,28,26,54,28.0,
847313017932,01793,2,2,4,1792.0,
847313017987,01798,2,1,3,1680.0,
847313018014,01801,1,2,3,1344.0,
847313018021,01802,1,2,3,1456.0,
847313018038,01803,1,2,3,1456.0,
847313018380,01838,2,1,3,1501.0,
847313008565,00856,0,0,0,1680.0,
847313009104,00910,0,2,2,1792.0,
847313011435,01143,0,0,0,1792.0,
847313011459,01145,1,1,2,1904.0,
847313012357,01235,1,0,1,2419.0,
847313014672,01467,2,0,2,2531.0,
847313015662,01566,1,0,1,2419.0,
847313015808,01580,2,1,3,1478.0,
847313015815,01581,1,1,2,2307.0,
847313015822,01582,1,0,1,2419.0,
847313016447,01644,0,0,0,1344.0,
847313016454,01645,2,1,3,1456.0,
847313016621,01662,0,0,0,1747.0,
847313018915,01891,0,0,0,1635.0,
847313019172,01917,0,0,0,1635.0,
847313008589,00858,0,0,0,153.0,
847313015099,01509,0,2,2,153.0,
847313015426,01542,9,5,14,80.0,
682146891690,CITSBS1218,0,0,0,494.0,
682146891713,CITSBS1218NKL,0,0,0,,
682146891706,CITSBS2018,0,0,0,494.0,
682146891720,CITSBS2018NKL,0,0,0,494.0,
682146891737,FT61228,0,0,0,569.99,
682146880816,FT61228NKL,0,0,0,569.99,
682146891744,FT62026,0,0,0,569.99,
682146860047,KAR1228,0,0,0,379.99,
682146860061,KAR2026Y,0,0,0,379.99,
682146860054,KAR2028,0,0,0,379.99,
682146860016,KAR2828,0,0,0,379.99,
682146860078,KAR41026Y,0,10,10,379.99,
682146860023,KAR41028,0,0,0,379.99,
682146302516,KIRFT3B-12,99,99,198,329.99,259.99
682146859119,KIRFT3B-28,0,0,0,329.99,
682146302530,KIRFT3B-410,0,0,0,329.99,
682146302561,KIRFT3G-12,99,99,198,329.99,
682146859126,KIRFT3G-28,0,0,0,329.99,
682146302585,KIRFT3G-410,0,0,0,329.99,
682146860092,PUP410S,2,13,15,149.99,
682146302578,KIRFT3G-20,99,68,167,329.99,
708279006258,AK-A1,4,0,4,9.99,
708279011023,AK-A19,0,0,0,11.99,
708279007224,AK-A2,99,99,198,9.99,
708279007286,AK-A3,0,12,12,9.99,
708279007309,AK-A5,78,1,79,10.99,
708279013959,AKSL-30,8,8,16,12.99,
708279000041,BRO-01,16,15,31,16.99,15.99
708279012594,BRO-03,5,0,5,16.49,
708279015458,BRO-A10,4,8,12,,
708279006609,BRO-A6,15,4,19,20.99,
708279013874,CAN-A1,10,48,58,15.49,
708279000089,COL-03,18,4,22,15.99,
708279000133,COL-08,15,3,18,17.49,
708279012099,COL-25,0,0,0,17.99,
708279015014,COL-30,0,33,33,7.99,
708279012679,COL-A16B,0,4,4,11.99,
708279010644,COL-A20,0,2,2,19.99,
708279012686,COL-A22B,0,0,0,11.99,
708279016363,COL-A33,92,35,127,14.99,13.99
708279012884,DPM-A2,0,0,0,12.99,
708279012891,DPM-A3,39,34,73,11.99,
708279013270,DPM-A4,2,29,31,17.99,
708279016028,DPM-A4-FDE,10,8,18,17.99,
708279013966,DRM-A1,0,13,13,79.99,
708279015724,DRM-A1-FDE,1,1,2,79.99,74.99
708279014390,DRM-A12,10,9,19,65.99,
708279014574,DRM-A22,0,3,3,76.99,
708279014963,DRM-A37,2,3,5,73.99,
708279015106,DRM-A41,4,5,9,79.99,
708279014178,DRM-A8,6,13,19,65.99,
708279014185,DRM-A9,0,2,2,66.99,
708279016097,DRM-A97,20,3,23,76.99,
708279008863,FNH-A2,0,0,0,30.99,
708279016042,FNH-A2-FDE,8,5,13,30.99,
708279011139,FNH-A3,0,0,0,14.49,
708279015748,FNH-A4-FDE,4,0,4,17.99,
708279013287,FNH-A5,17,6,23,20.99,
708279014994,FNH-A7,0,0,0,24.99,
708279013546,GLK-11,6,1,7,17.99,
708279013942,GLK-13,11,0,11,17.99,
708279015717,GLK-16,9,6,15,13.99,
708279015991,GLK-18-PRO,0,0,0,17.99,
708279013683,GLK-A11,12,0,12,12.99,
708279013690,GLK-A12,7,0,7,12.99,
708279015021,GLK-A18,7,12,19,13.99,
708279015229,GLK-A19,99,52,151,18.99,
708279016387,GLK-A22,99,89,188,20.99,19.99
708279016394,GLK-A23,61,79,140,22.99,20.99
708279010033,HIP-A3,7,12,19,17.99,
708279010682,M1A01,7,3,10,15.99,
708279006661,MIA-A1,0,0,0,16.99,15.99
708279011399,MKA-01,6,2,8,31.99,
708279014406,MKA-02,37,10,47,31.99,
708279013911,MKA-A1,26,22,48,88.99,
708279015090,MKA-A3,0,12,12,74.99,69.99
708279013621,RM-10,0,0,0,8.49,
708279014024,RM-10-FDE,2,18,20,8.49,
708279013638,RM-15,8,0,8,10.49,
708279013645,RM-20,6,0,6,10.49,
708279012204,RM-30,1,0,1,11.49,
708279012549,RM-40,7,5,12,14.99,
708279013614,RM-5,0,0,0,8.49,
708279013997,RM-5-FDE,7,0,7,8.49,
708279009013,RUG-14,0,0,0,17.99,
708279011405,RUG-16,10,1,11,16.49,
708279011412,RUG-17,2,1,3,18.49,
708279008993,RUG-A21,0,0,0,19.99,
708279009334,RUG-A22,3,0,3,11.49,
708279010934,RUG-A28,0,19,19,59.99,
708279006395,RUG-A3,0,0,0,21.49,
708279011177,RUG-A30,0,0,0,65.99,
708279011948,RUG-A33,3,0,3,16.99,
708279015076,RUG-A41,0,0,0,23.99,
708279015335,RUG-A42,0,0,0,18.49,17.49
708279015809,RUG-A43,3,7,10,19.99,
708279016219,RUG-A45,13,15,28,18.99,17.99
708279016240,RUG-A47,7,10,17,17.99,16.99
708279007125,RUG-A9,3,0,3,12.99,
708279009174,RUG-S30,40,16,56,26.49,
708279009815,SAI-A6,2,4,6,81.99,
708279015908,SIG-A21,59,0,59,20.99,19.99
708279013744,SIG-A14,0,0,0,17.49,
708279013751,SIG-A15,16,0,16,17.49,
708279016400,SIG-A23,31,0,31,24.99,23.99
708279007217,SIG-A5,4,3,7,18.99,
708279007231,SIG-A6,6,3,9,20.49,
708279013331,SIG-A8,9,1,10,17.99,
708279009853,SKS-A4,2,0,2,15.99,
708279011238,SMI-21,0,0,0,17.99,
708279012044,SMI-27,0,0,0,17.49,
708279012051,SMI-28,0,0,0,17.99,16.99
708279012075,SMI-30,1,0,1,17.49,
708279012082,SMI-31,3,0,3,17.99,
708279011368,SMI-A11,1,2,3,17.49,
708279011382,SMI-A12,0,1,1,17.49,
708279011641,SMI-A14,0,0,0,25.49,
708279015816,SPR-A16,1,0,1,17.99,16.99
708279015823,SPR-A17,0,0,0,24.99,
708279011955,SPR-A6,0,0,0,16.99,
708279012006,SPR10,0,4,4,17.99,
708279013515,TAU-A6,28,0,28,17.99,
708279013522,TAU-A7,0,0,0,23.99,
708279015700,FNH-A12,13,9,22,18.99,
682146873719,KPM1228,1,38,39,324.99,
682146873726,KPM2028,0,0,0,324.99,
682146873733,KPM2828,0,0,0,324.99,
682146873740,KPM41028,0,0,0,324.99,
814992004324,DP1000,17,2,19,19.99,17.99
814992012145,PD500,1,2,3,109.99,99.99
814992003686,PD500R,2,1,3,50.99,46.99
810170031885,PYDP1000PC,15,4,19,,
854857007947,PYRP3001,55,52,107,,
811907025375,PYS2510SDP,60,35,95,2.49,2.49
810170031861,PYS9910ST,12,12,24,4.99,4.99
810048732111,PYSB8610DT,28,20,48,5.49,4.99
814992008612,S4110S,22,23,45,13.49,
811907029953,VGBH9010C,18,6,24,10.99,9.99
810048735570,VGCOMBO110,30,10,40,14.99,12.99
810048735587,VGCOMBO210,10,6,16,14.99,12.99
810048735594,VGCOMBO310,25,10,35,14.99,12.99
810048735600,VGCOMBO410,26,3,29,14.99,12.99
811907020691,VGPM8010C,18,6,24,12.99,10.99
810170031793,VGPM8011C,12,0,12,12.99,10.99
811907029984,VGPM8063C,12,0,12,12.99,10.99
811907020646,VGPM9010C,33,32,65,9.99,8.99
811907020660,VGPM9010PC,18,0,18,9.99,8.99
810170030888,VGPME17,16,8,24,,
810170034268,VGPME30BT,20,5,25,74.99,64.99
810170038839,VGPME31BT,11,8,19,74.99,64.99
810170038846,VGPME32BT,17,2,19,74.99,64.99
810048732814,VGSB1710T,4,6,10,13.99,12.99
810048732821,VGSB1720T,35,17,52,13.99,12.99
811907021650,VGSB718T,6,6,12,13.99,12.99
811907023043,VGSB722T,8,3,11,13.99,12.99
810048732838,VGSG1710T,6,4,10,13.99,12.99
810048732845,VGSG1720T,6,11,17,13.99,12.99
811907023050,VGSG722T,8,6,14,13.99,12.99
810170030253,VGSGM1410T,5,2,7,13.99,12.99
810170030222,VGST1410T,4,6,10,13.99,12.99
810170030246,VGST1418T,8,4,12,13.99,12.99
810170030239,VGST1422T,4,0,4,13.99,12.99
811907021681,VGSG718T,14,10,24,13.99,12.99
810170032288,VGSUG710T,6,6,12,13.99,12.99
810170031878,VGSUG722T,4,3,7,13.99,12.99
814034027281,RF01668,39,30,69,469.99,
814034027267,RF01666,92,0,92,469.99,
814034027298,RF01669,31,77,108,469.99,419.99
814034026819,RF01625,99,99,198,469.99,
814034026840,RF01628,99,99,198,469.99,419.99
814034027243,RF01664,2,0,2,519.99,
844093067676,HT9-327S,99,99,198,12.99,
844093067683,HT9-327M,99,99,198,13.99,
844093067713,HT9-310-42,0,57,57,47.99,
844093000239,HT9-310-42-C,22,99,121,47.99,
810070685393,R96323,0,0,0,779.99,
810070685409,R96324,0,0,0,839.99,
810070685430,R96328,0,0,0,869.99,
810070685447,R96329,0,0,0,929.99,
810070685621,R96336,0,0,0,779.99,
810070685454,R96339,0,0,0,899.99,
810070685461,R96359,0,0,0,869.99,
810070685478,R96360,0,0,0,929.99,
810070685645,R96385,0,0,0,1119.99,
810070685690,R96492,0,0,0,869.99,
810070683993,R24991,0,0,0,869.99,
810070682828,R25012,0,0,0,779.99,
810070683849,R25077,23,26,49,419.99,
810070680008,R25315,0,0,0,1129.99,
810070680022,R25399,0,0,0,1129.99,
810070683856,R25549,33,10,43,419.99,
810070683863,R25559,3,10,13,419.99,
810070680640,R25787,0,0,0,899.99,
810070680657,R25791,0,0,0,899.99,
810070680664,R25793,0,0,0,899.99,
810070680671,R25803,0,0,0,929.99,
810070689575,R25804,0,0,0,899.99,
810070689582,R25805,0,0,0,899.99,
810070689599,R25806,0,0,0,929.99,
810070684006,R26927,0,2,2,789.99,
810070684013,R26929,0,0,0,789.99,
810070684020,R26947,0,0,0,789.99,
810070684037,R26949,0,0,0,789.99,
810070680701,R27007,0,0,0,929.99,
810070689605,R27008,0,0,0,929.99,
810070689612,R27010,0,0,0,929.99,
810070680725,R27011,0,0,0,929.99,
810070680749,R27017,0,0,0,929.99,
810070680756,R27047,0,0,0,964.99,
810070680763,R27049,0,0,0,964.99,
810070680282,R27093,15,10,25,539.99,
810070680299,R27094,23,15,38,539.99,
810070680305,R27095,17,5,22,539.99,
810070680312,R27097,10,0,10,539.99,
810070680329,R27099,14,0,14,539.99,
810070681586,R27357,0,0,0,649.99,
810070681593,R27359,6,3,9,649.99,
810070681609,R27361,7,0,7,649.99,
810070681616,R27363,10,8,18,649.99,
810070681623,R27385,0,0,0,649.99,
810070681630,R27387,8,5,13,649.99,
810070680039,R29549,0,0,0,1209.99,
810070688608,R68860,0,0,0,489.99,
810070688615,R68861,8,5,13,489.99,
810070688622,R68862,5,2,7,489.99,
810070688646,R68864,26,24,50,469.99,
810070688653,R68865,13,7,20,469.99,
810070688660,R68866,0,5,5,489.99,
810070688691,R68869,40,20,60,469.99,449.99
810070688707,R68870,42,20,62,469.99,
810070688714,R68871,18,10,28,469.99,449.99
810070688721,R68872,5,10,15,469.99,449.99
810070683887,R81192,5,11,16,509.99,
810070683917,R81198,6,4,10,559.99,
810070683955,R81212,7,0,7,559.99,
810070682972,R81230,0,0,0,419.99,
810070685133,R83392,0,0,0,919.99,
810070685157,R83441,0,0,0,959.99,
810070685164,R83442,0,0,0,919.99,
810070681678,R84148,43,17,60,649.99,
810070681715,R84158,0,0,0,909.99,
810070689254,R84159,0,0,0,909.99,
810070689247,R84160,9,4,13,909.99,
810070689230,R84161,0,0,0,909.99,
810070689650,R84167,0,0,0,909.99,
810070689667,R84168,0,0,0,909.99,
810070689674,R84169,0,0,0,909.99,
810070682064,R84203,0,0,0,749.99,
810070682071,R84204,4,5,9,749.99,
810070682101,R84207,4,6,10,719.99,
810070680343,R84600,16,10,26,539.99,
810070680398,R85407,19,4,23,539.99,
810070680404,R85417,13,8,21,559.99,
810070680411,R85418,3,7,10,559.99,
810070680428,R85425,6,4,10,559.99,
810070680466,R85447,47,15,62,539.99,
810070689353,R85743,0,0,0,464.99,
810070689360,R85744,0,0,0,464.99,
810070689377,R85745,0,0,0,464.99,
810070689384,R85746,0,0,0,464.99,
810070689391,R85747,0,0,0,464.99,
810070689414,R85749,0,0,0,464.99,
810070689407,R85757,0,0,0,464.99,
810070684297,R85773,0,0,0,459.99,
810070684310,R85826,5,4,9,419.99,
810070684327,R85832,11,17,28,419.99,
810070684334,R85834,9,3,12,419.99,
810070684358,R85836,37,5,42,419.99,
810070684365,R85837,4,3,7,419.99,
810070684068,R85838,0,0,0,419.99,
810070684372,R85839,9,5,14,419.99,
047700183640,18364,0,0,0,5.29,
047700194394,19439-REM,36,30,66,,
810070683023,R24401,12,9,21,,
810070683030,R24403,18,28,46,,
810070683047,R24407,57,7,64,,
810070683061,R24417,0,0,0,,
810070683085,R24421,0,0,0,,
810070683139,R24443,0,0,0,,
810070683146,R24447,0,0,0,,
810070683153,R24449,0,0,0,,
810070683344,R24901,1,15,16,,
810070683351,R24903,0,0,0,,
810070683382,R25047,0,0,0,,
810070681425,R86672,1,4,5,,
810070681432,R86673,2,3,5,,
850041390062,3C624LFI23,0,0,0,325.0,
850041390031,3P312ASI23,0,0,0,279.0,
850041390048,3P318LFI23,0,0,0,325.0,
850041390055,3P416AS23,0,0,0,245.0,
850041390215,3P416ASD23,0,0,0,245.0,
850041390017,3T18ASIBLK23,0,0,0,259.0,
850041390024,3T18ASIFDE23,0,0,0,259.0,
850041390116,5C428AFI23,0,0,0,539.0,
850041390109,5C428LFI23,0,0,0,539.0,
850041390093,5C525AFI23,0,0,0,479.0,
850041390086,5C525LFI23,0,0,0,479.0,
850041390079,5P212AS23,0,0,0,389.0,
850041390123,5T110LFI23,0,0,0,479.0,
850041390154,7C318LFI23,0,0,0,779.0,
850041390147,7C318LPFI23,0,0,0,779.0,
850041390161,7C324ASI23,0,0,0,839.0,
850041390178,7C324LFI23,0,0,0,839.0,
850041390192,7C432AFI23,0,0,0,959.0,
850041390185,7C432LFI23,0,0,0,959.0,
019962520365,X1H,0,4,4,24.0,
019962520167,XL1,6,0,6,24.0,
019962524868,X301QD,11,24,35,75.0,
019962520761,X30H,0,0,0,28.0,
019962520563,X30L,9,0,9,28.0,
019962520662,X30M,4,11,15,28.0,
019962520266,X1M,0,0,0,24.0,
019962527067,1TARD,0,0,0,115.0,
019962526961,1TRRD,99,99,198,115.0,65.0
019962527760,3TARD,99,99,198,173.0,
019962531262,3TMPRD,99,99,198,140.0,
019962532962,3TMPRD2,0,0,0,161.0,
019962533563,3TPRD2,99,99,198,161.0,
725327633587,2-RM641,0,0,0,434.99,
725327939627,2-RM649,0,0,0,454.99,
725327939917,2-RM661,0,0,0,434.99,
725327633648,2-RM669,0,0,0,454.99,
725327633624,2-RP631,0,0,0,324.99,
725327633631,2-RP639,0,0,0,334.99,
662205988738,920442093,0,0,0,614.99,
754908240302,920451613-TB,0,0,0,739.99,
662205988752,920452093,0,0,0,614.99,
754908232208,923571613-TB,0,0,0,739.99,
662205988769,923572013,0,0,0,579.99,
754908232000,923572013-GLD,0,0,0,644.99,
662205988776,923572093,0,0,0,614.99,
754908253005,923572093-LW,0,0,0,764.99,
754908211500,RB17H2111,0,0,0,159.99,
754908211401,RB22L1811,60,47,107,139.99,
754908211609,RB22W2111,44,16,60,159.99,
754908229703,RL22181SY,26,8,34,254.99,
754908229604,RL22181WD,30,27,57,289.99,
754908255702,RL22181WD-GLD1,12,18,30,339.99,
754908229901,RP22181SY,99,91,190,249.99,
754908229802,RP22181WD,16,8,24,284.99,
754908211302,RS22L1811,0,0,0,114.99,
754908254101,RS22L1811L,25,16,41,139.99,
754908212101,RS22L1811TL,15,23,38,114.99,
754908310807,RS22LP1811-TH,0,0,0,124.99,
754908213504,RS22W2111,18,11,29,249.99,
754908226405,RS22W2111-TH,26,17,43,254.99,
662205984624,SCJ4510,0,0,0,584.99,
725327628927,SCJ4510K,0,0,0,614.99,
662205985560,SCJ4510SS,0,0,0,629.99,
662205985553,SCJT4510,0,0,0,584.99,
754908231706,SSP1-BK,22,12,34,134.99,
754908299300,SSP1-BKAK,16,10,26,159.99,
754908232901,SSP1-OD,24,13,37,134.99,
754908275809,SSP20TKY,39,48,87,199.99,
754908234905,SSPTKY,30,10,40,174.99,
754908300303,RP22181SY-EN06,85,76,161,254.99,
754908299805,RP22181SY-EN01,99,77,176,254.99,214.99
662205988721,920442013,0,0,0,579.99,
754908232109,920442013-GLD,0,0,0,644.99,
754908232604,920442413,0,0,0,664.99,
662205988820,920451613,0,0,0,574.99,
662205988745,920452013,0,0,0,574.99,
754908310609,RP22181SY-EN11,0,32,32,254.99,
754908312504,RP22181SY-EN13,20,24,44,259.99,
754908312900,RP22181SY-EN14,18,15,33,259.99,
736676003068,0306,0,0,0,565.0,
736676003082,0308,0,0,0,634.0,
736676003099,KBN34-C,0,0,0,678.0,
736676003167,0316,0,0,0,565.0,
736676003181,0318,0,0,0,634.0,
736676003198,KBN36-C,0,0,0,678.0,
736676003334,0333,0,0,0,704.99,
736676004058,0405,0,0,0,565.0,
736676004065,0406,0,0,0,565.0,
736676004454,0445,0,0,0,565.0,
736676004461,0446,0,0,0,634.0,
736676004553,0455,0,0,0,565.0,
736676004638,0463,0,0,0,634.0,
736676004652,0465,0,0,0,565.0,
736676004775,0477,0,0,0,814.99,
736676005055,0505,0,0,0,565.0,
736676006212,0621,0,0,0,533.0,
736676006229,0622,0,0,0,533.0,
736676006236,0623,0,0,0,533.0,
736676006243,0624,0,0,0,533.0,
736676006250,KNR5-C,0,0,0,592.0,
736676006267,KNR6-C,0,0,0,592.0,
736676006298,0629,0,0,0,533.0,
736676006618,0661,0,0,0,533.0,
736676006625,KNR7H,0,0,0,741.0,
736676006762,0676,0,0,0,729.99,
736676008025,S47N-C,0,0,0,696.0,
736676008049,KS47N-C,0,0,0,696.0,
736676008063,KS411N-C,0,0,0,724.0,
736676008070,S411N-C,0,0,0,696.0,
736676008100,S45N-C,0,0,0,696.0,
736676008117,KS45N-C,0,0,0,696.0,
736676008131,S458N-C,0,0,0,696.0,
736676008148,KS458N-C,0,0,0,696.0,
736676008179,0817,0,0,0,764.99,
736676008605,KS-47NHNN,0,0,0,808.0,
736676008629,KS-47NHB,0,0,0,808.0,
736676008759,0875,0,0,0,854.99,
736676009121,SBC4,0,0,0,544.0,
736676009138,KSBC-4,0,0,0,582.0,
736676017027,GP141-C,0,0,0,651.0,
736676017041,GP161-C,0,0,0,651.0,
736676017058,KGP141-C,0,0,0,702.0,
736676017072,KGP161-C,0,0,0,702.0,
736676017157,KGPF331-C,0,0,0,678.0,
736676017409,1740,0,0,0,749.99,
736676017539,1753,0,0,0,879.99,
736676017546,1754,0,0,0,821.0,
736676017553,1755,0,0,0,821.0,
736676017577,1757,0,0,0,702.0,
736676017638,1763,0,0,0,749.99,
736676017737,1773,0,0,0,731.0,
736676017744,1774,0,0,0,731.0,
736676017751,1775-RUG,0,0,0,821.0,
736676017775,1777,0,0,0,934.99,
736676017805,1780,0,0,0,894.99,
736676017829,1782,0,0,0,869.99,
736676017836,1783,0,0,0,929.99,
736676017843,1784,0,0,0,979.99,
736676017867,1786,0,0,0,879.99,
736676017898,1789,0,0,0,879.99,
736676017904,1790,0,0,0,734.99,
736676020027,2002,99,99,198,176.0,
736676020034,2003,99,99,198,176.0,
736676020041,2004-RUG,48,71,119,176.0,
736676020140,2014,99,73,172,234.99,
736676020157,2015,50,68,118,187.0,
736676020164,2016,85,85,170,187.0,
736676020171,2017,62,35,97,187.0,
736676020300,2030,99,99,198,234.99,
736676020379,2037-RUG,38,35,73,176.0,
736676020386,2038,37,10,47,176.0,
736676020393,2039-RUG,28,26,54,176.0,
736676020409,2040,0,36,36,176.0,
736676020423,2042-RUG,28,24,52,176.0,
736676020430,2043,0,0,0,176.0,
736676020522,2052,19,0,19,176.0,
736676020539,2053,84,77,161,176.0,
736676020546,2054,57,0,57,176.0,
736676032532,3253,1,99,100,449.0,
736676032839,3283,99,99,198,232.0,
736676032853,3285,0,0,0,257.99,
736676032877,3287,43,0,43,257.99,
736676032891,3289,0,0,0,259.99,
736676032952,3295,99,99,198,256.0,256.0
736676032976,3297,99,74,173,244.0,
736676035007,3500,99,99,198,393.0,
736676035014,3501-RUG,99,0,99,393.0,
736676035021,3502,81,30,111,419.0,
736676035038,3503-RUG,0,0,0,393.0,
736676035113,3511,0,1,1,429.99,
736676035120,3512,28,69,97,424.99,
736676035137,3513,99,99,198,424.99,
736676036004,3600,0,0,0,374.0,
736676036042,3604,35,47,82,411.0,
736676036066,3606,74,8,82,404.99,
736676036073,3607,41,99,140,396.0,
736676036110,3611,75,53,128,399.99,
736676036134,3613,99,99,198,394.99,
736676036202,3620,75,16,91,392.0,
736676036257,3625,99,35,134,419.99,
736676036479,3647,92,95,187,414.99,
736676036554,3655,0,0,0,399.99,
736676037018,3701,99,88,187,222.0,
736676037254,3725,23,23,46,249.99,
736676037421,3742,99,99,198,249.99,
736676037452,3745-RUG,55,77,132,264.99,
736676037469,3746-RUG,63,84,147,249.99,
736676037520,3752,0,0,0,289.0,
736676037568,3756,0,0,0,249.99,
736676037919,3791,84,99,183,233.0,
736676038107,3810,99,99,198,313.0,
736676038114,3811,99,99,198,313.0,
736676038138,3813,98,99,197,359.99,
736676038152,3815,7,44,51,444.0,
736676038169,3816,24,18,42,359.0,
736676038183,3818,0,0,0,313.0,
736676038190,3819,0,0,0,326.0,
736676038213,3821-RUG,99,98,197,349.99,
736676038251,3825-RUG,99,88,187,444.0,
736676038299,3829,99,53,152,326.0,
736676038305,3830,0,0,0,359.0,
736676038329,3832,50,3,53,359.99,
736676038374,3837,99,99,198,349.99,
736676038381,3838,99,41,140,359.99,
736676038398,3839,0,0,0,251.0,251.0
736676038404,3840,0,0,0,379.99,
736676038558,3855,0,0,0,251.0,
736676049233,4923,89,99,188,262.0,
736676049240,4924,32,9,41,350.0,
736676049318,4931,0,0,0,294.99,
736676049325,4932,0,0,0,399.99,
736676049332,4933,0,0,0,399.99,
736676049349,4934,99,60,159,349.99,
736676049356,4935,47,0,47,492.0,
736676049370,4937-RUG,0,0,0,304.99,
736676049387,4938,0,0,0,290.0,
736676049400,4940,99,0,99,294.99,
736676050413,5041,0,0,0,914.0,
736676050437,5043,0,0,0,914.0,
736676050444,5044,0,0,0,914.0,
736676050505,5050,0,0,0,914.0,
736676050512,5051,0,0,0,914.0,
736676050598,5059,0,0,0,914.0,
736676050604,5060,0,0,0,914.0,
736676050659,5065-RUG,0,0,0,1233.0,
736676051014,NV-455,0,0,0,696.0,
736676051021,NV-44,0,0,0,696.0,
736676051045,KNV-455,0,0,0,696.0,
736676051052,KNV-44,0,0,0,696.0,
736676051069,NV-35,0,0,0,696.0,
736676051076,NV-34,0,0,0,696.0,
736676051083,KNV-35,0,0,0,696.0,
736676051090,KNV-34,0,0,0,696.0,
736676051205,5120,0,0,0,829.99,
736676051298,5129-RUG,0,0,0,756.0,
736676051304,5130,0,0,0,756.0,
736676051335,5133,0,0,0,756.0,
736676051342,5134,0,0,0,756.0,
736676051410,5141,0,0,0,809.99,
736676051441,5144,0,0,0,809.99,
736676051571,5157,0,0,0,1044.99,
736676051588,5158,0,0,0,744.99,
736676051595,5159,0,0,0,744.99,
736676051656,5165,0,0,0,909.99,
736676053018,KSRH-2454,0,0,0,999.0,
736676053025,5302,0,0,0,999.0,
736676053032,KSRH-2,0,0,0,999.0,
736676054015,5401,91,56,147,492.0,
736676054107,5410,4,0,4,492.0,
736676054305,5430-RUG,94,99,193,492.0,
736676054312,5431-RUG,68,16,84,492.0,
736676054350,5435-RUG,47,37,84,492.0,
736676054374,5437-RUG,0,0,0,492.0,
736676054398,5439,0,0,0,492.0,
736676054442,5444,0,0,0,569.0,
736676054503,5450,0,0,0,569.0,
736676054527,5452-RUG,0,25,25,569.0,
736676054565,5456,45,0,45,569.0,
736676054602,5460,0,0,0,569.0,
736676054626,5462,99,25,124,569.0,
736676054640,5464,0,0,0,569.0,
736676055012,KSRH7-C,0,0,0,972.0,
736676055029,KSRH9-C,0,0,0,972.0,
736676055050,KSRH-7454,0,0,0,999.0,
736676055074,5507,0,0,0,999.0,
736676055173,5517,0,0,0,1064.99,
736676057184,KSP321-C,1,5,6,608.0,
736676057191,KSP331-C,0,0,0,608.0,
736676057207,KSP321XL-C,38,43,81,608.0,
736676057375,KSP821-C,65,79,144,608.0,
736676057641,5764,0,0,0,859.99,
736676057658,5765,0,0,0,648.0,
736676057719,5771-RUG,0,0,0,648.0,
736676057733,5773-RUG,0,0,0,648.0,
736676057740,5774,0,0,0,759.99,
736676057825,5782,0,0,0,726.0,
736676057832,5783-RUG,0,0,0,608.0,
736676057849,5784,0,0,0,608.0,
736676057856,5785,0,0,0,849.99,
736676067008,6700,84,37,121,795.0,
736676067022,6702,0,0,0,795.0,
736676067114,6711,0,0,0,826.0,
736676067220,6722,0,0,0,826.0,
736676067367,6736,0,0,0,841.0,
736676067398,6739,0,0,0,841.0,
736676067565,6756,0,0,0,989.99,
736676067589,6758,0,0,0,826.0,
736676067596,6759,0,0,0,841.0,
736676067626,6762,0,0,0,826.0,
736676067688,6768,0,0,0,1074.99,
736676067732,6773,0,0,0,964.99,
736676067763,6776,0,0,0,1623.0,
736676081004,8100,0,0,0,592.0,
736676081509,8150-RUG,0,0,0,592.0,
736676086054,8605,75,59,134,457.0,
736676086184,8618,0,0,0,457.0,
736676086351,8635,0,0,0,457.0,
736676086375,8637,0,0,0,457.0,
736676086382,8638,0,0,0,457.0,
736676086399,8639,24,45,69,457.0,
736676086450,8645,0,0,0,457.0,
736676086481,8648,10,1,11,457.0,
736676086498,8649,0,0,0,457.0,
736676086504,8650,35,26,61,457.0,
736676086610,8661,0,0,0,457.0,
736676086634,8663,0,0,0,457.0,
736676086726,8672,0,4,4,457.0,
736676086832,8683,19,37,56,457.0,
736676105977,10597,0,0,0,744.99,
736676132003,13200,99,99,198,256.0,256.0
736676132010,13201,13,2,15,243.0,
736676132119,13211,99,99,198,261.0,
736676132133,13213,0,0,0,289.99,
736676137053,13705,99,25,124,289.0,
736676137107,13710,0,0,0,248.0,
736676137145,13714,99,99,198,318.0,
736676137169,13716,99,99,198,318.0,
736676137176,13717,0,0,0,349.99,
736676137190,13719,0,0,0,359.99,349.99
736676137213,13721,37,23,60,354.99,
736676137251,13725-RUG,48,94,142,314.99,
736676137268,13726,0,0,0,319.99,
736676137275,13727,0,0,0,314.99,
736676137350,13735,0,0,0,349.99,
736676137367,13736,99,99,198,354.99,354.99
736676137381,13738,0,0,0,379.99,
736676137398,13739,0,0,0,379.99,
736676137404,13740,0,0,0,379.99,
736676137411,13741,0,0,0,379.99,
736676137428,13742,0,0,0,379.99,
736676137435,13743,99,99,198,333.0,
736676157020,15702,0,0,0,608.0,
736676157044,15704,0,0,0,849.99,
736676157105,15710,0,0,0,764.99,
736676164011,16401,35,0,35,597.0,
736676164028,16402,2,17,19,597.0,
736676164035,16403,27,6,33,597.0,
736676164059,16405,18,16,34,654.99,
736676164066,16406,0,0,0,654.99,
736676164073,16407,5,0,5,654.99,
736676164127,16412,99,99,198,654.99,
736676164141,16414,0,99,99,674.99,
736676164158,16415,0,45,45,709.99,
736676291007,29100-RUG,0,0,0,597.0,
736676291014,29101,0,0,0,597.0,
736676401017,40101,98,65,163,440.0,
736676401031,40103,0,0,0,545.0,
736676401048,40104,10,0,10,369.0,
736676401055,40105,0,0,0,369.0,
736676401079,40107,7,99,106,344.0,
736676401123,40112,0,0,0,628.0,
736676401185,40118,0,0,0,648.0,
736676401260,40126,1,25,26,567.0,
736676401499,40149,55,55,110,435.0,
736676401505,40150,28,59,87,483.0,
736676401598,40159,25,10,35,483.0,
736676401604,40160,0,0,0,690.0,
736676401673,40167,99,99,198,499.99,
736676401734,40173,0,10,10,480.0,
736676401741,40174,0,0,0,575.0,
736676401772,40177,99,17,116,499.99,
736676439102,43910,0,0,0,499.99,
736676439157,43915,0,0,0,499.99,
736676439164,43916,0,0,0,499.99,
736676439218,43921,0,0,0,517.0,
736676439225,43922,99,99,198,544.99,
736676439263,43926,99,99,198,480.0,
736676439270,43927,99,99,198,480.0,
736676439324,43932,0,0,0,499.99,
736676439331,43933,0,0,0,499.99,
736676439348,43934,0,0,0,480.0,
736676439355,43935,0,0,0,499.99,
736676439454,43945,99,36,135,480.0,
736676439461,43946,99,99,198,559.99,
736676439478,43947,99,99,198,559.99,
736676439485,43948,99,99,198,559.99,
,BB-8353,0,0,0,,
736676011025,10/22-DSP,0,0,0,349.0,
736676011032,10/22-RB,99,99,198,260.0,
736676011513,1151,99,21,120,260.0,
736676012565,1256,99,99,198,289.0,
736676012619,1261,89,56,145,301.0,
736676012657,1265-RUG,0,0,0,359.99,
736676012961,1296,0,51,51,387.99,
736676058013,5801-RUG,0,0,0,837.0,
736676058020,5802,0,0,0,899.0,
736676058037,5803-RUG,0,0,0,889.99,
736676058044,5804,0,0,0,899.0,
736676058051,5805-RUG,0,0,0,899.0,
736676058068,5806,0,0,0,899.0,
736676058167,5816,0,0,0,887.0,
736676058174,5817,0,0,0,960.0,
736676058198,5819-RUG,0,0,0,984.0,
736676058471,5847-RUG,0,0,0,914.0,
736676058532,5853,0,0,0,960.0,
736676058549,5854,0,0,0,914.0,
736676058556,5855-RUG,29,0,29,837.0,
736676058648,5864,0,0,0,914.0,
736676058686,5868,0,0,0,984.0,
736676058860,5886,0,0,0,934.99,
736676058877,5887,0,0,0,979.99,
736676058884,5888,0,0,0,914.0,
736676058891,5889-RUG,0,0,0,887.0,
736676058907,5890,0,0,0,999.99,
736676068036,6803,0,0,0,960.0,
736676068210,6821,0,0,0,1012.0,
736676068227,6822,0,0,0,1012.0,
736676068296,6829,0,0,0,1012.0,
736676068371,6837,0,0,0,1012.0,
736676068418,6841,7,0,7,959.0,
736676069019,6901,86,99,185,395.0,
736676069026,6902,6,0,6,395.0,
736676069033,6903-RUG,36,36,72,395.0,
736676069040,6904,67,99,166,395.0,395.0
736676069064,6906,96,99,195,395.0,395.0
736676069071,6907,62,29,91,395.0,
736676069088,6908,87,16,103,395.0,
736676069095,6909-RUG,99,95,194,395.0,
736676069453,6945-RUG,86,31,117,410.0,
736676069736,6973-RUG,99,99,198,410.0,410.0
736676069743,6974,56,36,92,410.0,
736676072194,7219,0,0,0,893.0,
736676072200,7220,0,0,0,893.0,
736676072224,7222,0,0,0,823.0,
736676072255,7225,0,0,0,823.0,
736676072262,7226,0,0,0,893.0,
736676074167,7416-RUG,0,0,0,823.0,
736676074174,7417,0,0,0,823.0,
736676074198,7419,0,0,0,823.0,
736676083015,8301-RUG,6,11,17,307.0,
736676083039,8303,0,0,0,307.0,
736676083053,8305,3,25,28,334.0,
736676083060,8306,25,13,38,334.0,
736676083114,8311,0,0,0,307.0,
736676083121,8312,15,14,29,334.0,
736676083138,8313,34,23,57,307.0,307.0
736676083213,8321,0,0,0,307.0,307.0
736676083220,8322,0,0,0,334.0,
736676083237,8323,13,18,31,307.0,
736676083299,8329,0,0,0,392.0,
736676083312,8331,9,5,14,349.99,
736676083480,8348,17,31,48,423.0,
736676083497,8349,14,0,14,423.0,
736676083503,8350,0,0,0,423.0,
736676083510,8351,16,22,38,369.0,
736676083527,8352,0,11,11,369.0,
736676083534,8353,6,45,51,369.0,369.0
736676083596,8359,1,17,18,459.99,
736676083602,8360,0,0,0,446.0,
736676083640,8364,0,0,0,469.99,
736676083657,8365,0,0,0,469.99,
736676083664,8366,0,0,0,471.0,
736676083671,8367,0,0,0,449.0,
736676083688,8368,0,0,0,449.0,
736676083695,8369,0,0,0,449.0,
736676083725,8372,0,0,0,380.0,
736676083732,8373,0,0,0,380.0,
736676083749,8374,0,0,0,380.0,
736676083787,8378,0,0,0,492.0,
736676083848,8384,52,65,117,459.99,
736676083855,8385,0,0,0,459.99,
736676083862,8386,0,0,0,459.99,
736676083879,8387,40,21,61,404.99,
736676084005,8400-RUG,0,0,0,410.0,
736676084012,8401,0,0,0,410.0,
736676084029,8402-RUG,0,0,0,410.0,
736676084036,8403-RUG,0,0,0,410.0,
736676084043,8404-RUG,0,0,0,410.0,
736676084050,8405-RUG,0,0,0,410.0,
736676084067,8406,0,0,0,444.99,
736676084081,8408,0,0,0,449.99,
736676084104,8410-RUG,0,0,0,444.99,
736676084111,8411-RUG,0,0,0,444.99,
736676084227,8422,0,0,0,442.0,
736676085002,8500,99,99,198,675.0,
736676085026,8502,3,5,8,675.0,
736676085033,8503-RUG,0,99,99,734.99,
736676085064,8506,12,59,71,89.99,
736676085118,8511-RUG,0,4,4,675.0,
736676085149,8514,57,16,73,746.0,
736676085156,8515,73,31,104,707.0,
736676085163,8516,0,21,21,259.99,
736676085224,8522,1,0,1,867.0,
736676085262,8526,0,0,0,809.99,
736676085293,8529-RUG,99,38,137,686.0,
736676085309,8530,31,13,44,686.0,
736676085323,8532,47,2,49,867.0,
736676085354,8535,0,0,0,746.0,
736676085378,8537,2,2,4,686.0,
736676085385,8538,0,0,0,777.0,
736676085408,8540,16,14,30,819.99,
736676085415,8541,0,0,0,744.99,
736676085422,8542,0,0,0,746.0,
736676085507,8550,99,67,166,809.99,
736676111008,11100,99,99,198,369.0,
736676111121,11112,69,68,137,384.0,
736676111251,11125,99,92,191,444.99,
736676111626,11162,99,32,131,444.99,
736676111985,11198-TLO,44,0,44,394.99,
736676169313,16931,40,33,73,528.0,528.0
736676169320,16932,0,0,0,528.0,
736676169337,16933,0,0,0,528.0,
736676169344,16934,54,0,54,528.0,528.0
736676169504,16950,0,0,0,447.0,
736676169535,16953,20,0,20,581.0,
736676169764,16976,0,13,13,447.0,
736676169771,16977,11,0,11,467.0,
736676171088,17108-RUG,0,0,0,893.0,
736676171101,17110-RUG,0,0,0,893.0,
736676171118,17111,0,0,0,893.0,
736676171217,17121,0,0,0,953.0,
736676171224,17122,0,0,0,953.0,
736676171231,17123,0,0,0,953.0,
736676180257,18025,3,8,11,1409.99,
736676180288,18028,0,0,0,1280.0,
736676180295,18029,0,0,0,1280.0,
736676180424,18042,0,0,0,1280.0,
736676180448,18044,0,0,0,1409.99,
736676180455,18045,0,0,0,1409.99,
736676180462,18046,0,0,0,1409.99,
736676180806,18080,0,0,0,1679.0,
736676180813,18081,17,0,17,1679.0,
736676180837,18083,0,0,0,1679.0,
736676180844,18084,1,0,1,1705.0,
736676180851,18085,0,2,2,1705.0,
736676191000,19100,99,43,142,519.0,
736676191017,19101,69,11,80,519.0,
736676191024,19102,0,99,99,519.0,
736676191055,19105,0,0,0,589.99,
736676191130,19113,0,0,0,549.99,
736676191154,19115,0,0,0,580.0,
736676191161,19116,0,0,0,580.0,
736676191178,19117,0,0,0,580.0,
736676191208,19120,0,0,0,639.99,
736676191215,19121,0,0,0,611.0,
736676191222,19122,0,0,0,668.0,
736676191246,19124,0,0,0,668.0,
736676191260,19126-RUG,84,48,132,668.0,
736676191277,19127-RUG,0,0,0,611.0,
736676191291,19129,0,0,0,684.99,
736676191307,19130-RUG,21,0,21,613.0,
736676191321,19132-RUG,99,99,198,639.99,
736676191345,19134,10,0,10,613.0,
736676191352,19135,0,0,0,613.0,
736676191390,19139-RUG,0,0,0,549.99,
736676193004,19300,99,76,175,672.0,
736676193011,19301,15,9,24,672.0,
736676193028,19302,30,92,122,672.0,
736676193066,19306,0,0,0,724.99,
736676211029,21102,0,0,0,409.99,
736676211333,21133,15,0,15,528.0,
736676211388,21138,0,0,0,409.99,
736676211449,21144,45,5,50,389.99,
736676211524,21152,0,0,0,556.0,
736676211791,21179,0,0,0,399.99,
736676211821,21182,99,74,173,469.99,
736676211869,21186,0,1,1,528.0,
736676211883,21188,58,0,58,444.99,
736676211890,21189,0,0,0,444.99,
736676211968,21196,6,17,23,464.99,
736676211999,21199,0,0,0,394.99,
736676269167,26916,0,0,0,467.0,
736676269174,26917,0,0,0,467.0,
736676269181,26918,0,0,0,467.0,
736676269228,26922,17,43,60,447.0,
736676269235,26923,0,0,0,526.0,
736676269242,26924,0,0,0,526.0,
736676269259,26925,99,99,198,526.0,
736676269266,26926,83,78,161,526.0,
736676269273,26927,0,0,0,526.0,
736676269280,26928,0,0,0,526.0,
736676269297,26929,0,0,0,526.0,
736676269440,26944,0,0,0,447.0,
736676269488,26948,27,0,27,447.0,
736676269518,26951,0,47,47,611.0,
736676269525,26952,0,0,0,611.0,
736676269532,26953,65,99,164,611.0,611.0
736676269655,26965,0,0,0,447.0,
736676269686,26968,0,0,0,447.0,
736676269716,26971,0,0,0,447.0,
736676269730,26973,79,59,138,447.0,
736676269778,26977,0,0,0,489.99,
736676269785,26978,0,0,0,489.99,
736676269815,26981,0,0,0,447.0,
736676269839,26983,48,56,104,673.0,673.0
736676269853,26985,0,1,1,446.0,
736676269860,26986,66,0,66,526.0,
736676269877,26987,0,0,0,509.99,
736676269914,26991,0,0,0,489.99,
736676269938,26993,0,0,0,673.0,
736676269969,26996,0,13,13,734.99,
736676269976,26997,0,0,0,734.99,
736676269983,26998,0,0,0,704.99,699.99
736676311132,31113,37,99,136,291.0,291.0
736676311149,31114,56,0,56,252.0,
736676311200,31120,0,0,0,635.0,
736676311248,31124,0,0,0,479.99,
736676311279,31127,0,0,0,734.99,
736676311361,31136,0,0,0,399.99,
736676311385,31138,0,0,0,439.99,
736676311408,31140,0,0,0,294.99,
736676311439,31143,40,99,139,303.0,
736676311446,31144,0,0,0,429.99,
736676311484,31148,55,6,61,399.99,
736676311521,31152,99,0,99,447.0,
736676311538,31153,0,0,0,494.99,
736676311569,31156,0,0,0,494.99,
736676311576,31157,0,0,0,374.99,
736676311590,31159,0,0,0,303.0,
736676311613,31161,0,39,39,399.99,
736676311668,31166,0,0,0,297.99,
736676311675,31167,0,0,0,324.99,
736676311699,31169,40,17,57,299.99,
736676311712,31171,48,99,147,289.99,284.99
736676311729,31172,0,0,0,349.99,
736676311736,31173,99,0,99,349.99,
736676369188,36918,0,30,30,559.99,
736676369195,36919,0,0,0,559.99,
736676369232,36923,26,80,106,526.0,
736676369249,36924,99,40,139,526.0,
736676369256,36925,0,0,0,526.0,
736676369263,36926,32,4,36,447.0,
736676369485,36948,0,0,0,526.0,
736676371396,37139,0,0,0,827.0,
736676371402,37140-RUG,0,0,0,827.0,
736676371853,37185,0,0,0,1073.0,
736676371860,37186,0,0,0,1073.0,
736676471089,47108,0,0,0,953.0,
736676471171,47117,0,0,0,1073.0,
736676471188,47118,0,0,0,1073.0,
736676471249,47124-RUG,0,0,0,1073.0,
736676471256,47125,0,0,0,1073.0,
736676471300,47130,0,0,0,1073.0,
736676471393,47139,0,0,0,974.0,
736676471706,47170,0,0,0,1073.0,
736676471836,47183,0,0,0,1073.0,
736676471843,47184,0,0,0,1073.0,
736676471898,47189,0,0,0,1073.0,
736676471973,47197,0,0,0,1073.0,
736676471980,47198-RUG,0,0,0,1073.0,
736676056101,5610,0,0,0,883.0,
736676056118,5611,0,0,0,883.0,
736676056149,5614-RUG,0,0,0,883.0,
736676056156,5615-RUG,0,0,0,883.0,
736676571000,57100-RUG,0,0,0,1073.0,
736676571017,57101-RUG,0,0,0,1073.0,
736676571024,57102-RUG,0,7,7,1073.0,
736676571048,57104-RUG,0,0,0,928.0,
736676571055,57105-RUG,0,0,0,928.0,
736676571079,57107-RUG,0,0,0,928.0,
736676571086,57108-RUG,0,0,0,928.0,
736676571093,57109-RUG,0,0,0,928.0,
736676571208,57120-RUG,0,0,0,928.0,
736676571215,57121-RUG,0,0,0,928.0,
736676571222,57122,0,0,0,1073.0,
736676571239,57123,0,0,0,1073.0,
736676571246,57124-RUG,0,0,0,928.0,
736676571253,57125-RUG,0,0,0,928.0,
736676085484,8548,0,0,0,1420.0,
736676085514,8551,99,70,169,809.99,
736676900015,KP-16/8,5,4,9,26.99,
736676900053,BX-1,99,99,198,14.99,
736676900091,MAG/5,5,59,64,20.99,
736676900107,MAG/20,0,74,74,26.99,
736676900121,MAG/762,12,12,24,20.99,
736676900350,90035,0,0,0,33.99,
736676900459,AP-10,0,0,0,20.99,
736676900466,M-10,25,13,38,20.99,
736676900572,JX-1,7,0,7,16.99,
736676900626,M-9,0,0,0,20.99,
736676900763,JMX-1,41,58,99,16.99,
736676900886,P-18/10,9,5,14,26.99,
736676900893,P-17/10,5,17,22,26.99,
736676900909,JHX-1,0,0,0,22.99,
736676900985,KP18/10,28,23,51,26.99,
736676901760,MAG/7744,0,0,0,26.99,
736676902231,BX-1-CLR,0,0,0,16.99,
736676902293,AP10MKIII,0,0,0,20.99,
736676902309,P163,5,7,12,26.99,
736676902316,M10MKIII,0,0,0,20.99,
736676902330,KP18/15,20,9,29,26.99,
736676903252,90325,59,0,59,30.99,
736676903269,90326,11,10,21,30.99,
736676903337,90333,35,13,48,22.99,
736676903382,90338,38,88,126,26.99,
736676903399,90339,0,99,99,26.99,
736676903443,90344,19,19,38,14.99,
736676903450,90345,0,0,0,26.99,
736676903504,90350,10,3,13,30.99,
736676903511,90351,5,9,14,30.99,
736676903528,90352,5,1,6,45.99,
736676903535,90353,5,3,8,49.99,
736676903610,90361,99,99,198,22.99,
736676903634,90363,1,43,44,26.99,
736676903658,90365,0,3,3,26.99,
736676903665,90366,5,0,5,20.99,
736676903689,90368,3,4,7,30.99,
736676903696,90369,0,0,0,30.99,
736676903740,90374,1,2,3,26.99,
736676903825,90382,10,0,10,22.99,
736676903979,90397,5,5,10,22.99,
736676903986,90398,67,0,67,39.99,
736676904044,90404,6,0,6,30.99,
736676904051,90405,5,17,22,26.99,
736676904129,90412,12,28,40,30.99,
736676904167,90416,0,0,0,26.99,
736676904358,90435,3,0,3,26.99,
736676904402,90440,1,0,1,26.99,
736676904488,90448,89,63,152,15.99,
736676904518,90451,26,0,26,34.99,
736676904631,90463,0,28,28,18.99,
736676904846,90484,23,10,33,,
736676904853,90485,16,7,23,26.99,
736676905102,90510,12,4,16,26.99,
736676905126,90512,0,2,2,26.99,
736676905140,90514,0,0,0,26.99,
736676905485,90548,74,0,74,36.99,
736676905492,90549,3,1,4,33.99,
736676905607,90560,3,4,7,26.99,
736676905614,90561,5,0,5,26.99,
736676905621,90562-RUG,4,0,4,26.99,
736676905638,90563,7,0,7,26.99,
736676905737,90573,1,0,1,,
736676905850,90585,0,1,1,20.99,
736676905911,90591-RUG,99,99,198,22.99,
736676905997,90599,30,0,30,20.99,
736676906000,90600,3,3,6,26.99,
736676906178,90617,11,2,13,26.99,
736676906185,90618,1,0,1,26.99,
736676906215,90621,14,7,21,22.99,
736676906260,90626,88,99,187,26.99,
736676906338,90633,15,0,15,26.99,
736676906369,90636-RUG,0,22,22,26.99,
736676906376,90637,99,88,187,26.99,
736676906383,90638,5,26,31,26.99,
736676906390,90639-RUG,3,5,8,26.99,
736676906420,90642,19,11,30,42.99,
736676906437,90643,14,0,14,37.99,
736676906444,90644,21,12,33,37.99,
736676906451,90645,0,0,0,31.99,
736676906468,90646,0,5,5,31.99,
736676906475,90647,9,0,9,37.99,
736676906529,90652,0,0,0,26.99,
736676906673,90667,10,0,10,26.99,
736676906758,90675,0,0,0,26.99,
736676906796,90679,37,1,38,,
736676906819,90681,62,55,117,30.99,
736676906840,90684,0,62,62,42.99,
736676906864,90686,14,10,24,42.99,
736676906895,90689-RUG,51,99,150,,
736676906918,90691,0,0,0,42.99,
736676906949,90694,17,10,27,16.99,
736676906956,90695,0,0,0,16.99,
736676906963,90696,24,2,26,22.99,
736676906970,90697,8,48,56,37.99,
736676907007,90700-RUG,99,0,99,33.99,
736676907014,90701,12,32,44,33.99,
736676907113,90711,0,0,0,52.99,
736676907137,90713,5,15,20,26.99,
736676907144,90714,0,0,0,42.99,
736676907151,90715,0,0,0,26.99,
736676907168,90716,31,18,49,42.99,
736676907281,90728-RUG,0,0,0,26.99,
736676907298,90729,0,0,0,42.99,
736676907304,90730,0,0,0,26.99,
736676907311,90731,0,0,0,42.99,
736676907335,90733,39,24,63,26.99,
736676907342,90734,0,0,0,26.99,
736676907359,90735-RUG,7,0,7,42.99,
736676907366,90736,23,0,23,,
736676909780,90978-RUG,9,13,22,14.99,
736676909797,90979,10,5,15,34.99,
736676590889,59088,94,99,193,,
736676903412,90341,3,8,11,5.19,
736676903641,90364,6,1,7,5.19,
736676904037,90403,5,5,10,6.29,
736676904143,90414,17,2,19,20.99,
736676904150,90415,24,0,24,30.99,
736676904600,90460,0,21,21,9.79,
736676904617,90461,5,0,5,99.99,
736676904624,90462,0,55,55,59.99,
736676904839,90483,0,8,8,9.79,
736676905157,90515,0,0,0,9.79,
736676905164,90516,0,0,0,9.79,
736676906208,90620,5,5,10,6.29,
736676906314,90631,0,99,99,59.99,
736676906345,90634,0,3,3,9.79,
736676906406,90640,0,0,0,6.29,
736676906611,90661,4,5,9,9.79,
736676906680,90668-RUG,3,0,3,6.29,
736676907397,90739,0,0,0,184.99,
736676909872,90987,34,0,34,15.99,
736676900046,90004,5,0,5,28.99,
736676902248,90224,2,2,4,16.99,
736676902262,90226,0,0,0,8.99,
736676902286,90228,2,5,7,13.29,
736676902699,90269,3,0,3,26.99,
736676902705,90270,5,0,5,26.99,
736676902712,90271,0,0,0,26.99,
736676902729,90272,1,5,6,26.99,
736676902736,90273,4,5,9,26.99,
736676902743,90274,0,0,0,26.99,
736676902750,90275,0,0,0,26.99,
736676902767,90276,4,1,5,26.99,
736676902781,90278,8,0,8,26.99,
736676902798,90279,0,5,5,26.99,
736676902804,90280,4,4,8,26.99,
736676902811,90281,3,3,6,26.99,
736676902828,90282,5,0,5,26.99,
736676902835,90283,5,1,6,26.99,
736676902842,90284,5,5,10,26.99,
736676902859,90285,1,3,4,26.99,
736676902866,90286,4,2,6,26.99,
736676902873,90287,1,0,1,26.99,
736676902880,90288-RUG,1,0,1,26.99,
736676902897,90289,1,1,2,26.99,
736676902903,90290,0,2,2,26.99,
736676902910,90291,5,5,10,26.99,
736676902927,90292,3,1,4,26.99,
736676902934,90293,3,2,5,26.99,
736676902941,90294,5,0,5,26.99,
736676902958,90295,0,3,3,26.99,
736676903290,90329,9,1,10,6.29,
736676904068,90406,0,1,1,52.99,
736676904075,90407,4,3,7,52.99,
736676904082,90408,2,4,6,52.99,
736676904099,90409,6,1,7,52.99,
736676904105,90410,0,2,2,52.99,
736676904112,90411,5,2,7,52.99,
736676906789,90678,5,4,9,20.99,
736676907205,90720,4,3,7,,
736676907229,90722,0,0,0,,
736676907236,90723,0,0,0,26.99,
736676020218,2021,99,99,198,194.99,179.99
736676020263,2026,99,99,198,194.99,
736676035045,3504,99,99,198,509.99,
736676036417,3641,46,42,88,399.99,369.99
736676037506,3750,0,99,99,280.0,
736676037582,3758,0,99,99,346.0,
736676049394,4939,99,2,101,534.99,
736676086085,8608,99,99,198,443.0,
736676137114,13711,97,48,145,372.0,
736676137152,13715,0,9,9,314.99,
736676085170,8517,0,0,0,734.99,
736676083282,8328,65,0,65,349.99,
736676190003,19000,0,0,0,,
736676190010,19001-RUG,0,0,0,,
736676006830,0683,0,0,0,634.99,
736676032884,3288,0,0,0,254.99,
736676067664,6766,0,0,0,1839.99,
736676058662,5866,0,0,0,887.0,
736676311095,31109,0,1,1,349.99,
736676311101,31110,0,0,0,635.0,
736676068302,6830-RUG,0,0,0,851.0,
794023004892,18651,0,99,99,,
028634703029,SWBAT21H,67,38,105,,
028634708963,SWTK8BCP,21,0,21,,
028634706280,SWTK8CP,37,10,47,,
028634705436,SWA24S,99,99,198,,
028634706174,SWFR2SCP,25,11,36,,
028634700684,SWFRS,73,23,96,,
028634939206,SWHRT9B,71,12,83,,
028634105649,CK5TBS,99,24,123,,
661120999959,1182571,12,16,28,,
661120999973,1182572,24,22,46,,
661120999980,1182573,12,31,43,,
661120265368,1160822,13,20,33,,
661120265382,1168583,65,12,77,,
661120265757,1160825,22,19,41,,
661120265405,1179950,45,5,50,,
661120265429,1179962,51,24,75,,
661120076131,1100073,89,13,102,,
661120413677,1084312,45,27,72,,
,1200646,0,0,0,,
661120748076,1200650,0,0,0,,
082442928494,JRS20H315,1,0,1,1200.0,
082442928524,JRS20H316,0,0,0,1200.0,
082442928500,JRS20H318,0,0,0,1200.0,
082442928562,JRS20H319,0,1,1,1200.0,
082442928548,JRS20H331,0,0,0,1200.0,
082442928555,JRS20H382,8,4,12,1200.0,
082442928579,JRS20P315,1,0,1,1200.0,
082442928609,JRS20P316,0,0,0,1200.0,
082442928647,JRS20P319,1,2,3,1200.0,
082442928623,JRS20P331,0,0,0,1200.0,
082442928593,JRS20P370,1,1,2,1200.0,
082442928630,JRS20P382,12,8,20,1200.0,
011356577979,57797,0,0,0,769.99,
011356577986,57798,0,0,0,769.99,
011356577993,57799,0,0,0,769.99,
011356578006,57800,0,0,0,769.99,
011356578013,57801,0,0,0,769.99,
011356670007,67000,6,23,29,379.99,
011356670014,67001,2,9,11,379.99,
011356670045,67004,10,11,21,379.99,
062654136177,13617,3,22,25,159.99,
062654137754,13775,5,9,14,129.99,
062654137808,13780,0,0,0,129.99,
062654137839,13783,0,99,99,129.99,
062654137853,13785,0,0,0,129.99,
062654137907,13790,0,0,0,129.99,
062654137952,13795,13,7,20,129.99,
062654137976,13797,12,3,15,239.99,
062654138010,13801,50,11,61,159.99,
062654138027,13802,5,10,15,239.99,
062654138058,13805,12,9,21,129.99,
062654138102,13810,0,2,2,129.99,
062654138157,13815,9,9,18,199.99,
062654138232,13823,33,23,56,279.99,
062654138249,13824,50,17,67,354.99,
062654138348,13834,41,18,59,169.99,169.99
062654138362,13836,16,9,25,354.99,
011356184658,18465,0,0,0,1059.99,
011356185181,18518,0,0,0,1159.99,
011356185280,18528,0,0,0,739.99,
011356185297,18529,0,0,0,739.99,
011356188199,18819,0,0,0,369.99,
011356191373,19137,4,0,4,1159.99,
011356191533,19153-SAV,0,0,0,554.99,
011356196569,19656-SAV,0,0,0,804.99,
011356196576,19657,0,0,0,804.99,
011356197399,19739,0,0,0,739.99,
011356197405,19740,0,0,0,554.99,
011356199799,19979,0,0,0,599.99,
062654224348,22434,0,0,0,444.99,
062654224355,22435,0,0,0,444.99,
062654224409,22440,1,1,2,444.99,
011356224484,22448,7,9,16,1279.99,
011356229021,22902,0,1,1,1369.99,
011356229038,22903,2,0,2,1369.99,
011356229700,22970,2,0,2,924.99,
062654247002,24700,13,8,21,264.99,
062654257001,25700,9,19,28,309.99,
062654257254,25725,5,10,15,424.99,
062654257452,25745,7,4,11,479.99,
062654257520,25752,0,0,0,549.99,
062654257957,25795,28,0,28,469.99,
062654267000,26700-SAV,47,3,50,204.99,
062654267024,26702,33,19,52,279.99,
062654267215,26721-SAV,0,0,0,259.99,
062654267246,26724-SAV,0,0,0,314.99,
062654267369,26736,30,39,69,294.99,
062654267376,26737-SAV,32,6,38,294.99,
062654268007,26800-SAV,16,19,35,227.99,
062654287008,28700,4,9,13,222.99,
062654287022,28702,1,11,12,229.99,
062654287176,28717,0,0,0,269.99,
062654287503,28750,0,0,0,354.99,
062654288005,28800,9,0,9,424.99,
062654400001,40000,39,10,49,165.99,
062654400025,40002,8,0,8,169.99,
062654400605,40060,0,0,0,124.99,
062654400612,40061,20,6,26,165.99,
062654402036,40203,80,33,113,124.99,
062654402074,40207,10,2,12,214.99,
062654402104,40210,10,7,17,214.99,
062654451102,45110-SAV,31,20,51,149.99,
062654451201,45120-SAV,14,13,27,227.99,
062654451256,45125,69,0,69,227.99,
011356470010,47001,0,0,0,424.99,
011356470058,47005,22,0,22,564.99,
011356470065,47006,11,12,23,509.99,
011356470072,47007,22,0,22,444.99,
011356470089,47008,27,8,35,499.99,
062654472008,47200,45,17,62,249.99,
062654472152,47215,25,11,36,399.99,
062654472169,47216,2,0,2,306.99,
062654472411,47241,23,11,34,306.99,
062654472480,47248,16,15,31,524.99,
062654472497,47249,18,15,33,419.99,
062654472565,47256,0,0,0,759.99,
011356474001,47400,0,0,0,424.99,
062654477003,47700,0,0,0,324.99,
011356478009,47800,0,0,0,544.99,
011356478016,47801,0,0,0,479.99,
062654507014,50701,23,0,23,214.99,
062654507021,50702,28,0,28,214.99,
011356570000,57000-SAV,0,0,0,799.99,
011356570017,57001,0,0,0,799.99,
011356570024,57002,0,0,0,799.99,
011356570048,57004,9,11,20,799.99,
011356570062,57006,33,13,46,704.99,
011356570079,57007,0,9,9,704.99,
011356570086,57008,25,18,43,684.99,
011356570093,57009,0,0,0,704.99,
011356570192,57019,0,0,0,529.99,
011356570260,57026,0,0,0,724.99,
011356570376,57037,0,0,0,1169.99,
011356570383,57038,0,0,0,674.99,
011356570390,57039,4,5,9,674.99,
011356570406,57040-SAV,7,0,7,674.99,
011356570413,57041,0,0,0,674.99,
011356570420,57042,0,0,0,674.99,
011356570536,57053,0,0,0,749.99,
011356570550,57055-SAV,0,0,0,749.99,
011356570567,57056,16,11,27,749.99,
011356570574,57057,7,9,16,749.99,
011356570611,57061,0,5,5,674.99,
011356570659,57065,9,2,11,674.99,
011356570666,57066,12,7,19,674.99,
011356570673,57067,2,2,4,674.99,
011356570680,57068,0,0,0,674.99,
011356570734,57073,8,5,13,669.99,
011356570758,57075,5,5,10,669.99,
011356570772,57077,6,5,11,749.99,
011356570833,57083,2,3,5,749.99,
011356570864,57086,0,0,0,749.99,
011356570895,57089,0,0,0,749.99,
011356570901,57090,0,0,0,414.99,
011356570918,57091,0,0,0,414.99,
011356570925,57092,0,0,0,414.99,
011356570932,57093,42,68,110,414.99,
011356570949,57094,0,0,0,414.99,
011356570956,57095,99,0,99,414.99,
011356570963,57096,9,0,9,414.99,
011356570970,57097,0,0,0,414.99,
011356570987,57098,98,60,158,414.99,
011356570994,57099,45,7,52,414.99,
011356571007,57100-SAV,52,0,52,469.99,
011356571014,57101,0,0,0,499.99,
011356571021,57102,0,0,0,499.99,
011356571038,57103,0,0,0,499.99,
011356571045,57104,35,30,65,499.99,
011356571052,57105,0,0,0,499.99,
011356571069,57106,0,0,0,499.99,
011356571076,57107,0,0,0,499.99,
011356571083,57108,0,0,0,499.99,
011356571090,57109,0,0,0,499.99,
011356571366,57136,0,3,3,724.99,
011356571373,57137-SAV,2,0,2,684.99,
011356571397,57139,0,0,0,724.99,
011356571403,57140-SAV,9,0,9,799.99,
011356571410,57141,2,4,6,799.99,
011356571700,57170,0,0,0,749.99,
011356571731,57173,10,2,12,674.99,
011356571748,57174,0,0,0,414.99,
011356571755,57175-SAV,44,71,115,414.99,
011356571762,57176,88,56,144,414.99,
011356571779,57177,0,0,0,414.99,
011356571786,57178,29,3,32,414.99,
011356572325,57232,15,2,17,704.99,
011356572332,57233,0,0,0,324.99,
011356572349,57234,0,0,0,324.99,
011356572356,57235,65,0,65,324.99,
011356572363,57236,99,55,154,324.99,
011356572387,57238,0,0,0,324.99,
011356572400,57240,93,29,122,324.99,
011356572417,57241,34,42,76,324.99,
011356572455,57245,0,0,0,324.99,
011356572462,57246,44,24,68,324.99,
011356572509,57250,1,0,1,324.99,
011356572523,57252,6,0,6,324.99,
011356572547,57254,0,0,0,324.99,
011356572554,57255,0,17,17,324.99,
011356572578,57257,0,0,0,359.99,
011356572585,57258,84,0,84,359.99,
011356572592,57259,51,34,85,359.99,
011356572615,57261,64,84,148,359.99,
011356572639,57263,0,9,9,359.99,
011356572646,57264,0,38,38,359.99,
011356572660,57266,54,0,54,359.99,
011356572677,57267,7,0,7,359.99,
011356572691,57269,37,0,37,399.99,
011356572707,57270,23,0,23,399.99,
011356572721,57272,68,24,92,399.99,
011356572738,57273,45,5,50,399.99,
011356572745,57274,0,0,0,399.99,
011356572752,57275,0,0,0,399.99,
011356572769,57276,0,0,0,399.99,
011356572776,57277,0,24,24,399.99,
011356572783,57278,0,0,0,399.99,
011356572790,57279,0,32,32,399.99,
011356572813,57281,40,16,56,399.99,
011356572820,57282,52,0,52,399.99,
011356572837,57283,0,0,0,444.99,
011356572844,57284,0,0,0,444.99,
011356572851,57285,23,13,36,444.99,
011356572868,57286,0,0,0,444.99,
011356572875,57287,0,0,0,444.99,
011356572882,57288,0,7,7,444.99,
011356572899,57289,63,14,77,444.99,
011356572905,57290,0,0,0,444.99,
011356572912,57291,0,28,28,444.99,
011356573001,57300,38,0,38,554.99,
011356573025,57302,20,0,20,554.99,
011356573032,57303,33,8,41,554.99,
011356573049,57304,4,4,8,554.99,
011356573056,57305,0,0,0,554.99,
011356573070,57307,39,3,42,554.99,
011356573124,57312,0,0,0,554.99,
011356573131,57313,0,0,0,554.99,
011356573148,57314,0,5,5,554.99,
011356573155,57315,0,0,0,554.99,
011356573193,57319,15,0,15,554.99,
011356573209,57320,1,0,1,554.99,
011356573223,57322,0,0,0,554.99,
011356573247,57324,0,0,0,554.99,
011356573254,57325,0,0,0,554.99,
011356573360,57336,10,4,14,614.99,
011356573384,57338,14,4,18,614.99,
011356573414,57341-SAV,0,0,0,654.99,
011356573421,57342,0,0,0,654.99,
011356573445,57344,8,2,10,654.99,
011356573476,57347,18,13,31,654.99,
011356573513,57351,0,0,0,654.99,
011356573520,57352,0,0,0,654.99,
011356573537,57353,0,0,0,654.99,
011356573544,57354,0,0,0,654.99,
011356573568,57356,0,0,0,664.99,
011356573575,57357,11,0,11,664.99,
011356573605,57360,14,0,14,664.99,
011356573612,57361,6,4,10,664.99,
011356573650,57365,12,12,24,369.99,
011356573667,57366,0,17,17,369.99,
011356573674,57367,30,15,45,369.99,
011356573681,57368,91,26,117,369.99,
011356573698,57369,44,12,56,369.99,
011356573704,57370,0,0,0,369.99,
011356573711,57371,36,18,54,369.99,
011356573728,57372,50,25,75,369.99,
011356573735,57373,70,10,80,369.99,
011356573759,57375,0,0,0,634.99,
011356573766,57376,28,8,36,684.99,
011356573773,57377,99,9,108,554.99,
011356573780,57378,0,0,0,554.99,
011356574107,57410,12,3,15,974.99,
011356574114,57411,8,5,13,974.99,
011356574121,57412,4,0,4,974.99,
011356574138,57413,9,0,9,974.99,
011356574145,57414,2,0,2,974.99,
011356574152,57415,3,7,10,974.99,
011356574169,57416,0,0,0,974.99,
011356574183,57418,5,6,11,974.99,
011356574206,57420,8,5,13,974.99,
011356574893,57489,4,0,4,704.99,
011356574916,57491,0,0,0,684.99,
011356574930,57493,0,0,0,644.99,
011356574954,57495,5,0,5,984.99,
011356575340,57534,0,0,0,529.99,
011356575357,57535,0,0,0,554.99,
011356575364,57536,0,0,0,554.99,
011356575371,57537,7,0,7,654.99,
011356575395,57539,0,0,0,414.99,
011356575401,57540,0,0,0,369.99,
011356575418,57541,0,0,0,499.99,
011356575432,57543,91,0,91,359.99,
011356575449,57544,0,0,0,324.99,
011356575456,57545,0,0,0,444.99,
011356575463,57546,0,0,0,399.99,
011356575470,57547,0,0,0,324.99,
011356575487,57548,0,0,0,414.99,
011356575494,57549,0,0,0,829.99,
011356575500,57550,0,0,0,829.99,
011356575517,57551,0,0,0,829.99,
011356575524,57552,0,0,0,829.99,
011356575531,57553,0,0,0,829.99,
011356575548,57554,13,2,15,829.99,
011356575562,57556,8,5,13,1729.99,
011356575579,57557,4,0,4,1729.99,
011356575593,57559,2,1,3,1854.99,
011356575616,57561,2,0,2,1854.99,
011356575623,57562,8,11,19,1854.99,
011356575630,57563,0,0,0,1304.99,
011356575647,57564,0,0,0,1304.99,
011356575654,57565,0,0,0,1304.99,
011356575661,57566,0,0,0,1304.99,
011356575777,57577,9,3,12,1304.99,
011356575784,57578,10,0,10,1304.99,
011356575814,57581,0,0,0,1304.99,
011356575821,57582,2,0,2,1304.99,
011356575951,57595,9,6,15,554.99,
011356575968,57596,0,0,0,654.99,
011356576026,57602,4,0,4,1254.99,
011356576071,57607,1,1,2,1349.99,
011356576538,57653,18,8,26,1164.99,1099.99
011356576545,57654,8,11,19,1164.99,
011356576552,57655,7,4,11,1164.99,
011356576569,57656,4,8,12,1164.99,
011356576576,57657,0,0,0,1164.99,
011356576590,57659,4,2,6,1164.99,
011356576606,57660,2,1,3,1164.99,
011356576958,57695,8,0,8,1304.99,
011356576965,57696,2,4,6,1304.99,
011356576972,57697,8,3,11,1304.99,
011356576989,57698,12,5,17,1304.99,
011356577016,57701,3,1,4,1729.99,
011356577023,57702,0,0,0,1729.99,
011356577030,57703,1,0,1,1729.99,
011356577085,57708,5,2,7,1854.99,
011356577146,57714,3,2,5,1304.99,
011356577160,57716,0,0,0,1304.99,
011356577177,57717-SAV,0,0,0,1304.99,
011356577382,57738,8,5,13,974.99,
011356577399,57739,0,5,5,974.99,
011356577412,57741,5,3,8,974.99,
011356577436,57743,0,0,0,974.99,
011356577443,57744,3,0,3,974.99,
011356577450,57745,4,4,8,974.99,
011356577467,57746,4,0,4,974.99,
011356577481,57748,0,0,0,974.99,
011356577498,57749,0,0,0,974.99,
011356577504,57750-SAV,0,0,0,974.99,
011356577511,57751,0,0,0,974.99,
011356577535,57753,0,0,0,974.99,
011356577559,57755,0,0,0,974.99,
011356577566,57756,0,0,0,974.99,
011356577573,57757,0,0,0,974.99,
011356577580,57758,0,0,0,974.99,
011356577610,57761,0,0,0,974.99,
011356577696,57769,0,0,0,369.99,
011356577764,57776,1,1,2,1349.99,
011356577863,57786,4,0,4,1649.99,
011356578877,57887,3,1,4,2059.99,
011356578884,57888,4,3,7,2059.99,
011356578938,57893,0,0,0,2059.99,
011356579386,57938,8,3,11,1369.99,
011356579393,57939,12,8,20,1369.99,
011356579416,57941,4,5,9,1369.99,
011356579423,57942,10,4,14,1369.99,
011356580122,58012,20,0,20,1869.99,
062654607028,60702,15,0,15,219.99,
062654607035,60703,0,0,0,214.99,
062654702006,70200,7,6,13,249.99,
062654702013,70201,20,16,36,274.99,
062654702037,70203,17,24,41,284.99,
062654702488,70248,0,0,0,524.99,
062654702495,70249,1,2,3,419.99,
062654702563,70256,0,0,0,759.99,
062654705007,70500,20,5,25,269.99,
062654705014,70501-SAV,18,7,25,294.99,
062654705021,70502-SAV,0,0,0,354.99,
062654705038,70503,7,2,9,306.99,
062654705489,70548,32,25,57,524.99,
062654705496,70549,1,4,5,439.99,
062654705564,70556,4,2,6,759.99,
062654708008,70800-SAV,0,0,0,269.99,
062654708015,70801-SAV,31,23,54,294.99,
062654708022,70802-SAV,0,0,0,354.99,
062654708039,70803-SAV,26,18,44,306.99,
062654708480,70848,18,9,27,524.99,
062654708497,70849,9,3,12,439.99,
062654708565,70856,0,0,0,759.99,
062654907005,90700-SAV,0,0,0,244.99,
062654907555,90755,0,0,0,474.99,
062654917004,91700,0,0,0,306.99,
062654918001,91800,0,0,0,236.99,
062654918063,91806,0,0,0,294.99,
062654919367,91936,0,0,0,294.99,
062654919374,91937,0,0,0,294.99,
062654927454,92745,0,1,1,489.99,
062654932007,93200,0,0,0,254.99,
062654932076,93207,0,0,0,279.99,
062654932175,93217,0,0,0,306.99,
062654947001,94700,0,0,0,314.99,
062654947254,94725,14,8,22,469.99,
062654952005,95200,0,0,0,379.99,
062654957000,95700,0,0,0,244.99,
062654962004,96200,51,0,51,424.99,
062654962097,96209,0,0,0,304.99,
062654962103,96210,0,0,0,469.99,
062654962509,96250,0,0,0,404.99,
062654966361,96636,25,0,25,294.99,
062654966378,96637,0,0,0,294.99,
062654966996,96699-SAV,0,0,0,289.99,
062654967009,96700,74,0,74,259.99,
062654967016,96701,28,0,28,264.99,
062654967030,96703,0,0,0,324.99,
062654967054,96705,0,0,0,384.99,
062654967092,96709,0,0,0,239.99,
062654967115,96711,6,0,6,274.99,
062654967122,96712,1,1,2,299.99,
062654967177,96717,14,23,37,264.99,
062654967344,96734,0,0,0,369.99,
062654967658,96765,0,0,0,469.99,
062654967702,96770,0,0,0,489.99,
062654967719,96771,16,9,25,579.99,
011356969019,96901,18,14,32,336.99,
011356969156,96915,3,39,42,384.99,
011356969712,96971,17,0,17,449.99,
011356969729,96972,32,0,32,519.99,
011356969750,96975,52,0,52,359.99,
062654200052,20005,99,0,99,15.99,
062654300059,30005,28,0,28,14.49,
011356472052,47205,0,0,0,17.29,
011356551832,55183,0,0,0,104.99,
011356551856,55185,6,10,16,63.99,
011356551900,55190,0,0,0,122.49,
011356552303,55230,0,0,0,39.49,
011356552310,55231,0,0,0,39.49,
011356552327,55232,0,0,0,39.49,
011356552334,55233,0,0,0,39.49,
062654900013,90001,17,17,34,15.99,
062654900051,90005,0,0,0,15.99,
062654900075,90007,18,0,18,17.29,
062654900082,90008,25,0,25,26.49,
062654900099,90009,19,34,53,23.49,
062654900105,90010,35,12,47,29.49,
062654900198,90019,40,0,40,33.49,
011356900203,90020,13,2,15,17.29,
011356900227,90022,0,0,0,17.29,
062654900235,90023,0,0,0,17.29,
062654704598,70459,0,0,0,12.49,
011356670052,67005,6,0,6,364.99,
011356670069,67006,7,0,7,424.99,
011356670076,67007,15,5,20,424.99,
011356670090,67009,13,7,20,364.99,
011356670106,67010,6,0,6,424.99,
011356670113,67011,13,9,22,424.99,
011356670175,67017,0,5,5,429.99,
011356670373,67037,9,6,15,424.99,
011356670410,67041,12,12,24,424.99,
011356670458,67045,11,5,16,424.99,
011356232014,23201,2,1,3,799.99,
011356575838,57583,0,0,0,1304.99,
011356576040,57604,8,0,8,1299.99,
011356577351,57735,14,0,14,799.99,
011356577726,57772,1,0,1,1299.99,
011356578839,57883,3,1,4,789.99,
011356197665,19766,27,0,27,459.99,
810099570007,CPX-1-CBG3,0,0,0,194.0,
810099570014,CPX-1-CBPKG3,0,0,0,194.0,
810099570816,CPX-1-CBPKRDRG3,0,0,0,199.0,
810099570021,CPX-1-CBPUG3,0,0,0,194.0,
810099570823,CPX-1-CBPURDRG3,0,0,0,199.0,
810099570809,CPX-1-CBRDRG3,0,0,0,199.0,
810099570038,CPX-1-CBSBG3,0,0,0,194.0,
810099570830,CPX-1-CBSBRDRG3,0,0,0,199.0,
810099570205,CPX-1-TTBKG3,99,74,173,194.0,
810099570212,CPX-1-TTPKG3,27,54,81,194.0,
810099571011,CPX-1-TTPKRDRG3,27,19,46,199.0,
810099570229,CPX-1-TTPUG3,0,0,0,194.0,
810099571028,CPX-1-TTPURDRG3,0,0,0,199.0,
810099571004,CPX-1-TTRDRG3,34,13,47,199.0,
810099570236,CPX-1-TTSBG3,99,23,122,194.0,
810099571035,CPX-1-TTSBRDRG3,37,19,56,199.0,
810099570106,CPX-2-CBG3,99,99,198,184.0,
810099570113,CPX-2-CBPKG3,89,41,130,184.0,
810099570915,CPX-2-CBPKRDRG3,46,26,72,189.0,
810099570120,CPX-2-CBPUG3,0,0,0,184.0,
810099570922,CPX-2-CBPURDRG3,2,10,12,189.0,
810099570908,CPX-2-CBRDRG3,99,35,134,189.0,
810099570137,CPX-2-CBSBG3,67,0,67,184.0,
810099570939,CPX-2-CBSBRDRG3,34,15,49,189.0,
810099570311,CPX-2-TTPKG3,99,44,143,184.0,
810099571110,CPX-2-TTPKRDRG3,38,13,51,189.0,
810099570328,CPX-2-TTPUG3,0,0,0,184.0,
810099571127,CPX-2-TTPURDRG3,24,28,52,189.0,
810099571103,CPX-2-TTRDRG3,99,82,181,189.0,
810099570335,CPX-2-TTSBG3,0,0,0,184.0,
810099571134,CPX-2-TTSBRDRG3,36,37,73,189.0,
810099570304,CPX-2-TTG3,53,99,152,184.0,
810099571608,DVG-1-CB,0,0,0,194.0,
810099571615,DVG-1-CBPK,0,14,14,194.0,
810099571813,DVG-1-CBPKRDR,6,1,7,199.0,
810099571820,DVG-1-CBPURDR,1,3,4,199.0,
810099571806,DVG-1-CBRDR,0,0,0,199.0,
810099571639,DVG-1-CBSB,17,3,20,194.0,
810099571837,DVG-1-CBSBRDR,8,5,13,199.0,
850013592012,DVG-1-TT,99,57,156,194.0,
810099571714,DVG-1-TTPK,0,0,0,194.0,
810099571912,DVG-1-TTPKRDR,15,16,31,199.0,
810099571721,DVG-1-TTPU,0,0,0,194.0,
810099571929,DVG-1-TTPURDR,9,13,22,199.0,
810099571905,DVG-1-TTRDR,3,0,3,199.0,
810099571738,DVG-1-TTSB,99,61,160,194.0,
810099571936,DVG-1-TTSBRDR,42,26,68,199.0,
810099571622,DVG-1-CBPU,0,7,7,194.0,
857679003043,01-006,0,0,0,23.0,
857679003906,03-006-91,2,19,21,23.0,
857679003005,CPX-1-CB,0,0,0,193.0,
810099570069,CPX-1-CBDEG3,17,8,25,194.0,
810099570861,CPX-1-CBDERDRG3,11,7,18,199.0,
810099570847,CPX-1-CBSGRDRG3,5,0,5,199.0,
857679003012,CPX-1-TT,99,99,198,193.0,
810099570274,CPX-1-TTCRG3,14,0,14,194.0,
850013592135,CPX-1-TTCRRD,0,0,0,304.0,
810099571073,CPX-1-TTCRRDRG3,8,1,9,199.0,
810099570267,CPX-1-TTDEG3,29,13,42,194.0,
810099571066,CPX-1-TTDERDRG3,15,7,22,199.0,
857679003081,CPX-1-TTPK,0,99,99,193.0,
857679003326,CPX-1-TTSB,0,16,16,193.0,
810099570243,CPX-1-TTSGG3,40,16,56,194.0,
810099571042,CPX-1-TTSGRDRG3,12,8,20,199.0,
857679003029,CPX-2-CB,0,99,99,184.0,
810099570977,CPX-2-CBCRRDRG3,1,5,6,189.0,
810099570168,CPX-2-CBDEG3,5,0,5,184.0,
810099570960,CPX-2-CBDERDRG3,14,4,18,189.0,
810099570199,CPX-2-CBORG3,0,0,0,184.0,
810099570144,CPX-2-CBSGG3,76,28,104,184.0,
810099570946,CPX-2-CBSGRDRG3,30,12,42,189.0,
857679003036,CPX-2-TT,99,0,99,184.0,
810099570373,CPX-2-TTCRG3,25,0,25,184.0,
850013592296,CPX-2-TTCRRD,61,0,61,293.0,
810099571172,CPX-2-TTCRRDRG3,4,2,6,189.0,
810099570366,CPX-2-TTDEG3,85,36,121,184.0,
850013592302,CPX-2-TTDERD,99,0,99,293.0,
810099571165,CPX-2-TTDERDRG3,40,13,53,189.0,
857679003067,CPX-2-TTPK,99,99,198,184.0,
850013592340,CPX-2-TTSBRD,0,0,0,293.0,
810099570342,CPX-2-TTSGG3,99,23,122,184.0,
810099571141,CPX-2-TTSGRDRG3,51,18,69,189.0,
810099571868,DVG-1-CBDERDR,3,0,3,199.0,
810099571646,DVG-1-CBSG,1,1,2,194.0,
810099571844,DVG-1-CBSGRDR,0,1,1,199.0,
810099571776,DVG-1-TTCR,6,7,13,194.0,
810099571974,DVG-1-TTCRRDR,3,2,5,199.0,
810099571769,DVG-1-TTDE,7,9,16,194.0,
810099571967,DVG-1-TTDERDR,10,4,14,199.0,
810099571981,DVG-1-TTLGRDR,0,1,1,199.0,
810099571790,DVG-1-TTOR,8,4,12,194.0,
810099571998,DVG-1-TTORRDR,5,3,8,199.0,
810099571943,DVG-1-TTSGRDR,3,0,3,199.0,
857679003104,DVG-1-CBLP,0,0,0,254.99,
661120651581,1182523,25,21,46,,
661120651604,1182525,44,9,53,,
661120651628,1182528,32,23,55,,
661120651536,1182531,36,11,47,,
661120651543,1182532,31,13,44,,
661120651550,1182533,1,9,10,,
661120651567,1182534,13,11,24,,
661120650218,1182618,36,21,57,,
661120650225,1182619,32,11,43,,
661120650232,1182620,25,7,32,,
661120650249,1182621,38,10,48,,
661120650263,1182623,33,0,33,,
661120652014,1184040,17,11,28,,
661120651710,1185977,24,13,37,,
661120650485,1182277,28,29,57,,
661120650850,1182503,32,6,38,,
661120650898,1182511,0,0,0,,
661120650966,1182518,12,13,25,,
661120650478,1136251,29,21,50,,
661120651116,1159289,29,17,46,,
661120651673,1159294,19,12,31,,
661120650768,1159295,18,9,27,,
661120650775,1159304,24,9,33,,
661120651109,1159310,42,21,63,,
661120650607,1159313,49,16,65,,
661120650546,1159314,33,17,50,,
661120651130,1159327,36,22,58,,
661120650829,1159330,16,10,26,,
661120650454,1136250,1,3,4,,
044356225502,SCAXE10,12,7,19,,
810013431537,SS-1003,5,5,10,711.2,
810013431544,SS-1004,8,2,10,711.2,
810013431551,SS-1005,3,7,10,695.2,
810013431568,SS-1006,4,3,7,695.2,
810013431599,SS-1009,19,0,19,791.2,
810013431605,SS-1010,2,6,8,791.2,
810013431612,SS-1011,0,0,0,775.2,
810013431629,SS-1012,0,3,3,775.2,
810013431667,SS-1016,7,4,11,711.2,
810013431681,SS-1018,3,6,9,695.2,
810013431728,SS-1022,2,5,7,791.2,
810013431742,SS-1024,5,6,11,775.2,
810013431759,SS-1025,10,6,16,815.2,
810013431766,SS-1026,5,5,10,815.2,
810013431773,SS-1027,2,2,4,799.2,
810013431780,SS-1028,5,3,8,799.2,
810013431902,SS-1040,1,0,1,775.2,
810013439236,SS-1306,24,30,54,577.15,577.15
810013439250,SS-1334,6,1,7,577.15,
810013432572,SS-2003,5,10,15,727.2,
810013432589,SS-2004,7,6,13,727.2,
810013432596,SS-2005,5,4,9,711.2,
810013432602,SS-2006,9,7,16,711.2,
810013432619,SS-2009,3,1,4,807.2,
810013432626,SS-2010,4,5,9,807.2,
810013432633,SS-2011,0,5,5,791.2,
810013432640,SS-2012,9,3,12,791.2,
810120310350,SS-2027,11,0,11,799.2,
810120310367,SS-2028,13,1,14,799.2,
810013432800,SS-2040,0,0,0,791.2,
810120310381,SS-2055,0,2,2,799.2,
810120310398,SS-2056,0,2,2,799.2,
810013437478,SS-2211,2,1,3,879.2,
810013437485,SS-2212,18,18,36,879.2,
810013437492,SS-2239,3,5,8,879.2,
810013439304,SS-2306,31,14,45,577.15,
810013439328,SS-2334,4,3,7,577.15,
810013432879,SS-3003,5,8,13,727.2,
810013432886,SS-3004,17,5,22,727.2,
810013432893,SS-3005,14,0,14,711.2,
810013432909,SS-3006,7,6,13,711.2,
810013432916,SS-3009,0,0,0,807.2,
810013432923,SS-3010,8,4,12,807.2,
810013432930,SS-3011,6,4,10,791.2,
810013432947,SS-3012,3,1,4,791.2,
810013432961,SS-3016,6,6,12,727.2,
810013432985,SS-3018,7,5,12,711.2,
810013433005,SS-3022,8,0,8,807.2,
810013433029,SS-3024,3,4,7,791.2,
810013439366,SS-3306,25,15,40,577.15,
810013436075,SS-4001,17,11,28,577.15,
810013436082,SS-4002,8,2,10,577.15,
810013436099,SS-4005,2,0,2,628.15,
810013436105,SS-4006,1,11,12,628.15,
810013436112,SS-4011,0,0,0,679.15,
810013436129,SS-4012,0,11,11,679.15,
810013436136,SS-4029,6,2,8,577.15,
810013436174,SS-4039,5,3,8,679.15,
810013436181,SS-4040,3,0,3,679.15,
810013438185,SG9S-00-56-10,0,0,0,19.49,
810013438192,SG9S-00-56-13,0,22,22,20.99,
810013431148,SG9C0203TSPL-BZ,0,0,0,149.25,
810013433418,SG9CL0003TSP-BZ,0,0,0,149.25,
810013436600,SS-3018-P,2,2,4,,
810013433678,SS-1006-P,0,0,0,,
810013433708,SS-1009-P,1,9,10,,
810013433722,SS-1011-P,0,0,0,,
810120310725,SS-1012-BHP,18,10,28,,
810013436266,SS-1022-P,0,0,0,,
810013434569,SS-1028-P,1,2,3,,
810013439243,SS-1306-P,1,7,8,,
810013434644,SS-2006-P,0,0,0,,
810013434682,SS-2012-P,0,0,0,,
810013438970,SS-2211-P,0,3,3,,
810013438987,SS-2212-P,8,4,12,,
810013439311,SS-2306-P,2,0,2,,
810013434781,SS-3004-P,1,0,1,,
810013434804,SS-3006-P,0,0,0,,
810013434828,SS-3010-P,0,0,0,,
810013434835,SS-3011-P,0,0,0,,
810013434842,SS-3012-P,0,0,0,,
810013436648,SS-3024-P,0,2,2,,
810013439373,SS-3306-P,7,3,10,,
810013437294,SS-4001-P,6,4,10,,
810013437300,SS-4002-P,4,5,9,,
810013437317,SS-4005-P,1,0,1,,
810013437324,SS-4006-P,0,7,7,,
810013437331,SS-4011-P,3,4,7,,
810013437348,SS-4012-P,1,0,1,,
810013436846,SS-1010-GE,47,26,73,823.2,823.2
810120310732,SS-1010-HGE,99,99,198,1047.2,1047.2
810013433746,SS-1510,54,34,88,989.0,
810120310701,SS-4506,99,99,198,789.99,786.38
810120310718,SS-4512,99,99,198,949.99,937.07
798681317479,798681317479,0,0,0,1046.0,
798681436170,798681436170,0,0,0,1133.0,
798681504138,798681504138,0,0,0,1133.0,
798681437139,798681437139,0,0,0,1133.0,
798681503995,798681503995,0,0,0,1133.0,
798681437146,798681437146,0,0,0,1133.0,
798681544752,798681544752,0,0,0,1656.0,
798681402144,798681402144,0,0,0,879.0,
798681437238,798681437238,0,0,0,879.0,
798681662982,798681662982,0,0,0,1133.0,
798681662999,798681662999,43,18,61,1133.0,1133.0
798681663002,798681663002,0,1,1,1407.0,
798681663019,798681663019,0,0,0,1407.0,
798681596607,798681596607,0,0,0,1133.0,
798681406562,798681406562,9,0,9,879.0,
798681430376,798681430376,0,10,10,879.0,
798681666102,798681666102,2,0,2,1133.0,
798681666119,798681666119,4,4,8,1133.0,
798681450107,798681450107,0,0,0,1133.0,
798681450053,798681450053,0,0,0,1046.0,
798681582495,798681582495,0,0,0,1133.0,
798681582501,798681582501,0,0,0,1133.0,
798681662715,798681662715,0,0,0,1918.0,
798681676347,798681676347,0,0,0,1918.0,
798681662722,798681662722,0,0,0,1918.0,
798681676354,798681676354,0,0,0,1918.0,
798681406586,798681406586,3,0,3,879.0,
798681430413,798681430413,0,0,0,879.0,
798681434732,798681434732,0,0,0,1046.0,
798681666126,798681666126,4,0,4,1133.0,
798681617166,798681617166,0,0,0,571.0,
798681654475,798681654475,6,0,6,1055.0,
798681513505,798681513505,0,0,0,483.0,
798681505951,798681505951,6,5,11,448.0,
798681676811,798681676811,6,1,7,610.0,
798681678747,798681678747,0,0,0,610.0,
798681553372,798681553372,0,0,0,483.0,
798681607556,798681607556,51,6,57,566.0,566.0
798681618040,798681618040,0,0,0,566.0,
798681506019,798681506019,22,11,33,448.0,438.0
798681676828,798681676828,11,9,20,610.0,
798681678754,798681678754,0,3,3,610.0,
798681582686,798681582686,65,31,96,566.0,566.0
798681652341,798681652341,0,9,9,697.0,
798681665051,798681665051,0,0,0,1046.0,
798681618286,798681618286,10,3,13,871.0,871.0
798681618293,798681618293,0,0,0,871.0,871.0
798681641925,798681641925,13,3,16,1395.0,
798681621309,798681621309,1,0,1,854.0,
798681621316,798681621316,0,0,0,854.0,
798681663620,798681663620,12,7,19,566.0,
798681646432,798681646432,8,2,10,871.0,
798681621347,798681621347,4,15,19,854.0,
798681621354,798681621354,3,0,3,854.0,
798681663644,798681663644,12,0,12,566.0,
798681665815,798681665815,99,66,165,479.0,
798681640447,798681640447,99,99,198,351.0,351.0
798681640454,798681640454,0,0,0,351.0,
798681640157,798681640157,99,99,198,448.0,448.0
798681640164,798681640164,99,99,198,448.0,448.0
798681667598,798681667598,3,0,3,592.0,
798681671618,798681671618,0,0,0,523.0,
798681679966,798681679966,0,0,0,644.0,
798681602995,798681602995,0,0,0,448.0,
798681681228,798681681228,0,0,0,479.0,
798681681235,798681681235,0,0,0,479.0,
798681663859,798681663859,0,0,0,527.0,
798681663866,798681663866,0,0,0,527.0,
798681663873,798681663873,0,0,0,527.0,
798681669981,798681669981,99,99,198,697.0,697.0
798681677344,798681677344,0,0,0,828.0,
798681681686,798681681686,0,0,0,653.0,
798681663675,798681663675,0,41,41,527.0,
798681663897,798681663897,0,0,0,527.0,
798681663903,798681663903,0,7,7,527.0,
798681663910,798681663910,0,0,0,527.0,
798681679973,798681679973,0,0,0,773.0,
798681443352,798681443352,0,0,0,571.0,
798681582532,798681582532,0,0,0,615.0,
798681504114,798681504114,0,0,0,571.0,
798681616022,798681616022,0,0,0,615.0,
798681406609,798681406609,0,0,0,879.0,
798681666140,798681666140,11,0,11,1133.0,1133.0
798681626632,798681626632,18,10,28,1395.0,
798681666157,798681666157,25,11,36,1133.0,1133.0
798681626649,798681626649,18,1,19,1395.0,
798681648436,798681648436,23,5,28,1759.0,1759.0
798681406623,798681406623,0,0,0,879.0,
798681662760,798681662760,7,0,7,1231.0,
798681666164,798681666164,36,6,42,1133.0,
798681626656,798681626656,7,1,8,1395.0,
798681666171,798681666171,20,15,35,1133.0,1133.0
798681626663,798681626663,11,3,14,1395.0,
798681448739,798681448739,11,7,18,959.0,
798681450695,798681450695,0,0,0,959.0,
798681437313,798681437313,0,0,0,1046.0,
798681582983,798681582983,0,0,0,959.0,
798681439126,798681439126,0,0,0,959.0,
798681677351,798681677351,0,0,0,1231.0,
798681673162,798681673162,0,0,0,2287.0,
798681673179,798681673179,0,0,0,2199.0,
798681660841,798681660841,0,0,0,2179.0,
798681661831,798681661831,0,0,0,2179.0,
798681660865,798681660865,0,0,0,2179.0,
798681671748,798681671748,0,7,7,1656.0,
798681671762,798681671762,10,0,10,1831.0,
798681671779,798681671779,20,10,30,1743.0,
798681681372,798681681372,0,0,0,3662.0,
798681437528,798681437528,0,0,0,527.0,
798681625789,798681625789,0,0,0,1395.0,
798681630288,798681630288,4,0,4,1569.0,
798681625796,798681625796,0,0,0,2199.0,2199.0
798681625819,798681625819,4,0,4,1395.0,
798681630295,798681630295,0,0,0,1569.0,
798681625826,798681625826,0,0,0,2199.0,
798681622207,798681622207,4,0,4,1307.0,
798681666249,798681666249,0,0,0,1495.0,
798681597765,798681597765,37,0,37,753.0,753.0
798681672677,798681672677,16,6,22,1046.0,1046.0
798681656363,798681656363,0,0,0,1099.0,
798681639519,798681639519,1,0,1,1495.0,
798681664634,798681664634,14,6,20,1133.0,1133.0
798681660872,798681660872,0,0,0,2179.0,
798681660889,798681660889,0,0,0,2179.0,
798681666751,798681666751,0,6,6,1743.0,
798681674022,798681674022,0,0,0,3662.0,
798681629718,798681629718,0,0,0,38.0,
798681649921,798681649921,42,36,78,45.5,
798681655717,798681655717,5,0,5,38.0,
798681655793,798681655793,20,6,26,38.0,
798681657100,798681657100,83,12,95,23.0,
798681657117,798681657117,99,61,160,31.0,
798681660254,798681660254,0,0,0,43.5,
798681661497,798681661497,3,5,8,38.0,
798681666997,798681666997,10,8,18,38.0,
798681412129,798681412129,10,0,10,23.0,
798681408979,798681408979,0,0,0,23.0,
798681111282,798681111282,0,2,2,38.0,
798681257850,798681257850,1,1,2,38.0,
798681118236,798681118236,2,0,2,38.0,
798681243297,798681243297,0,2,2,38.0,
798681527847,798681527847,0,0,0,38.0,
798681410224,798681410224,0,0,0,38.0,
798681118205,798681118205,0,4,4,38.0,
798681108602,798681108602,1,0,1,38.0,
798681408849,798681408849,0,0,0,38.0,
798681261536,798681261536,0,0,0,38.0,
798681265749,798681265749,0,0,0,38.0,
798681408825,798681408825,18,0,18,38.0,
798681464784,798681464784,2,2,4,38.0,
798681257843,798681257843,3,2,5,38.0,
798681415465,798681415465,0,0,0,38.0,
798681421749,798681421749,0,0,0,38.0,
798681415250,798681415250,1,0,1,38.0,
798681429806,798681429806,0,0,0,38.0,
798681583607,798681583607,0,0,0,38.0,
798681583614,798681583614,0,0,0,38.0,
798681583621,798681583621,0,0,0,38.0,
798681616886,798681616886,0,0,0,38.0,
798681439737,798681439737,2,0,2,38.0,
798681439744,798681439744,2,2,4,38.0,
798681605644,798681605644,1,0,1,,
798681505111,798681505111,2,0,2,38.0,
798681505128,798681505128,2,2,4,38.0,
798681505166,798681505166,0,2,2,38.0,
798681505067,798681505067,0,0,0,38.0,
798681505074,798681505074,22,5,27,38.0,
798681505135,798681505135,0,0,0,38.0,
798681505142,798681505142,2,1,3,38.0,
798681505173,798681505173,0,0,0,38.0,
798681505081,798681505081,0,0,0,38.0,
798681505098,798681505098,42,51,93,38.0,
798681599585,798681599585,28,21,49,38.0,
798681555253,798681555253,71,8,79,38.0,
798681599592,798681599592,51,22,73,38.0,
798681505104,798681505104,0,0,0,38.0,
798681505050,798681505050,1,2,3,38.0,
798681511471,798681511471,0,0,0,315.5,
798681543175,798681543175,0,0,0,315.5,
798681598939,798681598939,1,1,2,109.5,
798681605767,798681605767,0,0,0,36.0,
798681598823,798681598823,1,0,1,58.0,
798681598847,798681598847,2,2,4,36.0,
798681598854,798681598854,2,0,2,23.0,
798681598991,798681598991,0,0,0,23.0,
798681598861,798681598861,0,2,2,109.5,
798681643233,SOF21000,0,0,0,89.99,
798681591428,SOF36501,0,0,0,74.99,
798681521715,SOA10003,0,0,0,40.61,
798681521708,SOA10004,0,0,0,40.61,
798681521722,SOA10005,0,0,0,40.61,
798681521746,SOA10006,3,0,3,40.61,
798681521739,SOA10007,10,0,10,40.61,
798681521753,SOA10008,9,2,11,40.61,
798681581368,SOJ31001,0,0,0,262.49,
798681639250,SOJ3M001,2,2,4,151.99,
798681563142,SOJ41001,0,0,0,303.99,
798681581375,SOJ61001,0,0,0,350.69,
798681661589,SOK3K602,2,3,5,239.99,
798681628025,SOK5K705,0,5,5,529.99,
798681640539,SOK6K104,12,2,14,836.99,
798681659210,SOK6K105,7,9,16,989.99,
798681640546,SOK6K804,6,2,8,760.99,
798681665877,SOR01030,0,0,0,136.99,
798681665884,SOR01130,4,4,8,174.99,
798681578153,SOR11000,3,0,3,230.99,
798681616534,SOR1P100,0,0,0,326.99,
798681616541,SOR1P101,0,0,0,326.99,
798681662470,SOR21000,1,0,1,608.99,
798681647699,SOR21300,7,2,9,532.99,
798681647705,SOR21600,1,0,1,,
798681521357,SOR31002,1,0,1,280.02,
798681567850,SOR43012,1,0,1,245.06,
798681567867,SOR43021,0,1,1,314.99,
798681567874,SOR43022,0,1,1,314.99,
798681567881,SOR43031,1,0,1,402.99,
798681553396,SOR52001,0,0,0,119.99,
798681521388,SOR71001,10,0,10,149.99,
798681618675,SOR72001,40,20,60,81.49,
798681619382,SOR72002,0,0,0,81.49,
798681590643,SOR81002,0,0,0,532.99,
798681596652,SOR81003,0,0,0,554.99,
798681582693,SORJ53101,0,0,0,367.49,
798681638161,SORJ72001,0,0,0,209.99,
798681627998,SOSBDX62111,1,2,3,707.99,
798681628001,SOSBDX63111,2,3,5,783.99,
798681628018,SOSBDX65111,0,2,2,1099.99,
798681642502,SOT61000,0,0,0,288.99,
798681640522,SOT61230,0,1,1,1139.99,
798681600342,SOT61231,2,2,4,1289.99,
798681613786,SOT61239,1,1,2,1289.99,
798681600113,SOT65113,0,0,0,1574.99,
798681600120,SOT65114,1,0,1,1711.99,
798681656097,SOTM11000,0,0,0,449.99,
798681656127,SOTM81000,0,0,0,364.99,
798681599691,SOW33201,10,0,10,146.99,
798681599974,SOW33202,9,0,9,149.99,
798681599806,SOW34201,5,0,5,227.99,
798681599721,SOW34202,10,0,10,189.99,
798681665181,SOW63111,28,16,44,609.99,
798681666973,SOW63113,8,4,12,609.99,
798681639069,SOZ61001,1,1,2,532.99,
798681639076,SOZ61601,0,0,0,645.99,
798681525904,798681525904,0,0,0,82.12,
798681557875,798681557875,0,0,0,88.01,
798681568093,798681568093,0,0,0,88.01,
798681528318,798681528318,0,2,2,142.22,
798681528455,798681528455,0,0,0,142.22,
798681599837,SOT41111,5,1,6,334.99,294.99
798681423668,W220R-45-BSS,0,18,18,,
798681423828,WE26R-40-BSS,0,19,19,,
798681423743,WE26R-9-BSS,0,19,19,,
798681423873,WE29R-9-BSS,0,4,4,,
798681437139,1911R45BSSCA-LE,0,4,4,1133.0,
798681437146,1911R45SSSCA-LE,0,0,0,1133.0,
,226R-9-BSSCA-LE,0,6,6,,
798681450107,226R-9SCPNCA-LE,0,0,0,1133.0,
798681434732,229R-9-ESECA-LE,0,29,29,1046.0,
798681617166,238-380TS2CA-LE,0,0,0,571.0,
798681437313,MK-25-CA-LE,0,10,10,1046.0,
798681673834,SIGP365A003,0,99,99,,
798681437528,SP2022-9-BSCALE,0,42,42,527.0,
798681581191,W1911FTCA-45SCP,0,37,37,,
798681580965,W1911R-45-ESCPN,0,19,19,,
798681665846,W220R-45-BSE,0,32,32,,
798681665853,WE26R-9-BSE,0,38,38,,
798681629381,WE26R-9-LEGION,0,8,8,,
798681651207,W320AXGCA-9-BXR,0,13,13,,
798681651214,W320AXGF-9-BXR,0,70,70,,
798681624430,W320C-9-BSS-RXP,0,26,26,,
798681613991,W320C-9-BXR3-PR,0,0,0,,
798681621446,W320C-9-BXR3-PX,0,5,5,,
798681633449,W320CA-9-BXR3X6,0,33,33,,
798681621453,W320CA-9-BXR3XP,0,0,0,,
798681608676,W320CA-9-COY,0,18,18,,
798681607532,W320CA-9-M18-MS,0,6,6,,
798681620319,W320CA-9-M18MSB,0,0,0,,
798681474233,W320F-9-BSS,0,0,0,,
798681632688,W320F-9-BXLDCXP,0,12,12,,
798681621460,W320F-9-BXR3-RX,0,9,9,,
798681614011,W320F-9-BXR3RXP,0,0,0,,
798681594153,W320F-9-M17-MS,0,0,0,,
798681620326,W320F-9-M17-MSB,0,20,20,,
798681588053,W320XC-9-BXR3,0,0,0,,
798681588022,W320XCA-9-BXR3,0,0,0,,
798681586073,W320XCA-9-BXR3C,0,17,17,,
798681667420,W365-380-BSS,0,19,19,,
798681593439,W365-9-BXR3,0,0,0,,
798681629169,W365-9-SAS,0,12,12,,
798681666577,W365X-9-BXR3RZE,0,0,0,,
798681666584,W365X-9-BXR3P,0,0,0,,
798681671373,W365XCA-9-RX,0,0,0,,
798681671311,W365XCA-9-RXZE,0,0,0,,
798681671335,W365XCA-9-RXSNS,0,0,0,,
798681618811,W365XL-9-BXR3,0,0,0,,
798681666591,W365XL-9-BXR3ZE,0,0,0,,
798681666607,W365XL-9-BXR3P,0,0,0,,
798681665860,WE29R-9-BSE,0,20,20,,
798681629428,WE29R-9-LEGION,0,24,24,,
798681629435,WE29R-9-LEG-RXP,0,10,10,,
798681654857,WRM400-556N-16B,0,0,0,,
798681578894,WRMCX-16B-TAP-P,0,5,5,,
798681637287,WRMPX-16B-9,0,27,27,,
798681613120,MODX-45,0,0,0,,
798681613137,MODX-9,0,0,0,,
798681642649,SLH300TI,0,0,0,,
798681642656,SLH300TI-QD,0,0,0,,
798681642595,SLH762-QD,0,0,0,,
798681642601,SLH762C,0,0,0,,
798681642618,SLH762C-QD,0,0,0,,
798681642557,SLH762TI-QD,0,0,0,,
798681642564,SLH762TIC,0,0,0,,
798681642571,SLH762TIC-QD,0,0,0,,
798681629046,SLX556,0,0,0,,
798681629053,SLX556-QD,0,0,0,,
798681629299,SLX556C,0,0,0,,
798681629305,SLX556C-QD,0,0,0,,
798681629114,SLX762-QD,0,0,0,,
798681629312,SLX762C,0,0,0,,
798681629329,SLX762C-QD,0,0,0,,
798681677887,798681677887,0,0,0,699.99,
798681677894,798681677894,0,0,0,729.99,
798681650897,798681650897,0,0,0,509.99,
798681671144,798681671144,0,0,0,589.99,
798681607945,798681607945,0,0,0,1099.99,
798681667161,798681667161,0,0,0,1529.99,
798681662548,SOA10033,11,10,21,22.99,
798681662555,SOA10034,0,0,0,22.99,
798681662562,SOA10035,0,0,0,22.99,
798681664498,SOBM10421,22,12,34,99.99,
798681651832,SOBM33001,99,99,198,89.99,
798681651849,SOBM33002,95,39,134,99.99,
798681651856,SOBM43001,31,38,69,94.99,
798681664313,SOBM44001,45,0,45,155.99,
798681644919,SOK15601,51,35,86,119.99,
798681667826,SORJ72501,99,58,157,245.99,
022188864823,10048,99,40,139,374.0,374.0
022188868005,10061,0,0,0,769.0,769.0
022188868012,10064-SW,0,0,0,769.0,769.0
022188865813,10110-SW,19,6,25,349.0,349.0
022188866360,10186,13,7,20,505.0,505.0
022188866506,10199,34,29,63,349.0,349.0
022188868548,10201,22,10,32,373.0,373.0
022188868036,10227,0,0,0,1017.0,1017.0
022188868432,10242,23,8,31,362.0,362.0
022188867824,10270,0,0,0,1134.0,1134.0
022188867886,10297,22,5,27,387.0,387.0
022188030396,103039,47,33,80,349.0,349.0
022188030433,103043,0,2,2,592.0,592.0
022188030617,103061,1,2,3,887.0,887.0
022188030723,103072,0,1,1,752.0,752.0
022188033519,103351,0,0,0,592.0,592.0
022188038101,103810,99,67,166,418.0,418.0
022188083903,108390,73,27,100,335.0,335.0
022188084115,108411,9,5,14,1261.0,1261.0
022188084825,108482,37,34,71,879.0,879.0
022188084832,108483,15,13,28,1305.0,1305.0
022188084856,108485,8,4,12,1305.0,1305.0
022188864076,108490,50,16,66,361.0,361.0
022188093810,109381,99,18,117,315.0,315.0
022188869156,11522,14,4,18,502.0,502.0
022188869224,11523,15,4,19,502.0,502.0
022188869248,11525,5,10,15,502.0,502.0
022188869750,11526,6,9,15,502.0,502.0
022188868135,11531,99,96,195,401.0,401.0
022188868319,11536,3,0,3,373.0,373.0
022188869057,11537,99,94,193,502.0,502.0
022188869064,11595,1,0,1,502.0,502.0
022188870008,11623,0,0,0,1576.0,1576.0
022188870220,11626,0,0,0,1627.0,1627.0
022188869743,11663,99,99,198,361.0,361.0
022188871852,11684,4,12,16,478.0,478.0
022188872392,11687,9,2,11,478.0,478.0
022188875966,11695,4,4,8,478.0,478.0
022188870503,11704,7,0,7,401.0,401.0
022188870169,11726,17,13,30,473.0,473.0
022188871265,11759,0,0,0,932.0,932.0
022188871449,11760,0,0,0,932.0,932.0
022188871043,11765,3,2,5,540.0,540.0
022188870664,11766,0,1,1,540.0,540.0
022188871159,11767,93,20,113,628.0,628.0
022188871609,11769,7,8,15,628.0,628.0
022188871289,11796,99,68,167,461.0,461.0
022188872248,11812,10,6,16,401.0,401.0
022188872095,11814,8,12,20,401.0,401.0
022188871173,11820,5,10,15,580.0,580.0
022188871401,11831,12,12,24,625.0,625.0
022188871425,11833,3,11,14,643.0,643.0
022188870671,11864,13,8,21,461.0,461.0
022188873573,11868,99,50,149,468.0,468.0
022188871937,11905,0,99,99,425.0,425.0
022188871944,11906,0,19,19,425.0,425.0
022188871968,11908,0,19,19,366.0,366.0
022188872682,11989,21,17,38,502.0,502.0
022188871913,11995,17,17,34,327.0,327.0
022188871920,11996,14,19,33,327.0,327.0
022188872415,11998,63,14,77,327.0,327.0
022188872422,11999,27,13,40,327.0,327.0
022188874952,12039,0,0,0,1025.0,1025.0
022188874969,12040,0,0,0,773.0,773.0
022188874891,12056,15,20,35,447.0,447.0
022188875300,12058,5,0,5,447.0,447.0
022188875546,12078,6,6,12,599.0,599.0
022188875539,12079,3,2,5,775.0,775.0
022188875560,12080,9,8,17,599.0,599.0
022188875553,12081,6,5,11,775.0,775.0
022188875447,12105,3,14,17,478.0,478.0
022188876628,12106,4,4,8,478.0,478.0
022188234008,123400,11,4,15,327.0,327.0
022188234039,123403,0,13,13,347.0,347.0
022188239003,123900,26,13,39,327.0,327.0
022188239027,123902,9,0,9,327.0,327.0
022188239034,123903,97,99,196,325.0,325.0
022188879209,12436,99,99,198,413.0,413.0
022188879216,12437,99,74,173,413.0,413.0
022188882827,12438,49,27,76,497.0,497.0
022188882810,12439,25,5,30,497.0,497.0
022188877724,12460,0,0,0,677.0,677.0
022188877731,12462,0,0,0,889.0,889.0
022188877748,12463,0,0,0,889.0,889.0
022188877533,12465,1,2,3,478.0,478.0
022188877038,12466,3,0,3,478.0,478.0
022188878462,12470,10,5,15,748.0,748.0
022188877700,12473,6,3,9,468.0,468.0
022188878516,12481,16,2,18,478.0,478.0
022188878387,12482,7,5,12,478.0,478.0
022188877113,12487,17,6,23,540.0,540.0
022188885200,12615,99,99,198,479.0,479.0
022188878585,12643,8,11,19,667.0,667.0
022188879308,12717,34,22,56,451.0,451.0
022188879315,12718,26,11,37,451.0,451.0
022188879179,12719,63,29,92,451.0,451.0
022188882506,13001-SW,71,65,136,480.0,480.0
022188882513,13002-SW,9,10,19,480.0,480.0
022188880212,13008-SW,5,0,5,478.0,478.0
022188881806,13010-SW,6,0,6,478.0,478.0
022188305111,130511,0,0,0,1232.0,1232.0
022188305128,130512,0,0,0,1232.0,1232.0
022188884951,13194,99,45,144,693.0,693.0
022188884760,13198,0,0,0,781.0,781.0
022188884777,13199,0,0,0,781.0,781.0
022188883879,13223,32,34,66,514.0,514.0
022188884029,13225,35,21,56,514.0,514.0
022188884920,13246,99,61,160,326.0,326.0
022188885149,13247,17,15,32,326.0,326.0
022188885118,13248,99,81,180,326.0,326.0
022188885125,13249,23,3,26,326.0,326.0
022188886290,13251,11,3,14,678.0,678.0
022188886504,13252,99,43,142,468.0,468.0
022188886511,13253,17,7,24,685.0,685.0
022188886528,13254,23,14,37,461.0,461.0
022188886535,13255,20,6,26,487.0,487.0
022188884814,13323,0,0,0,993.0,993.0
022188884807,13331,0,0,0,1254.0,1254.0
022188891218,13347,0,0,0,545.0,545.0
022188893564,13348-SW,0,0,0,545.0,545.0
022188885637,13387,34,69,103,523.0,523.0
022188885620,13388,24,25,49,523.0,523.0
022188885811,13389,16,15,31,514.0,514.0
022188885644,13390,47,34,81,514.0,514.0
022188887419,13458,99,99,198,413.0,413.0
022188887402,13459,99,91,190,413.0,413.0
022188890068,13473,99,99,198,370.0,370.0
022188890129,13474,17,54,71,370.0,370.0
022188888652,13534,97,50,147,370.0,370.0
022188888669,13536,90,99,189,370.0,370.0
022188889062,13558,2,7,9,370.0,370.0
022188889055,13559,3,4,7,370.0,370.0
022188889628,13563,6,10,16,514.0,514.0
022188889703,13564,38,31,69,523.0,523.0
022188889581,13567,8,5,13,523.0,523.0
022188889710,13568,17,9,26,514.0,514.0
022188889543,13570,8,6,14,514.0,514.0
022188889604,13571,10,5,15,514.0,514.0
022188889574,13572,12,7,19,514.0,514.0
022188889635,13573,8,9,17,514.0,514.0
022188891416,13591,99,99,198,413.0,413.0
022188891423,13592,99,87,186,413.0,413.0
022188891607,13658,0,0,0,725.0,
022188892307,13691,0,0,0,454.99,441.0
022188892253,13692,0,49,49,439.99,431.0
022188892246,13694,1,99,100,454.99,441.0
022188892697,13717-SW,0,0,0,781.0,781.0
022188892901,13718,0,0,0,781.0,781.0
022188892925,13734,29,11,40,523.0,523.0
022188895063,13948,0,0,0,554.0,
022188894899,13949,99,99,198,327.0,
022188895117,13950,99,99,198,327.0,
022188895025,13951,0,0,0,396.0,
022188129915,150145,0,0,0,1097.0,1097.0
022188131314,150184,0,0,0,682.0,682.0
022188133059,150254,0,0,0,938.0,938.0
022188133578,150256,0,0,0,945.0,945.0
022188134360,150339,0,0,0,959.0,959.0
022188134391,150341,0,0,0,993.0,993.0
022188137392,150466,21,12,33,432.0,432.0
022188138146,150477,0,0,0,924.0,924.0
022188138177,150481,0,0,0,945.0,945.0
022188137545,150544,59,56,115,418.0,418.0
022188141580,150712,0,0,0,786.0,786.0
022188141573,150713,0,0,0,786.0,786.0
022188141566,150714,0,0,0,889.0,889.0
022188141597,150715,0,0,0,866.0,866.0
022188142259,150717,0,0,0,889.0,889.0
022188142266,150718,0,0,0,924.0,924.0
022188142242,150783,0,0,0,1083.0,1083.0
022188142228,150784,0,0,0,845.0,845.0
022188142235,150785,4,6,10,652.0,652.0
022188142358,150786,0,0,0,697.0,697.0
022188145175,150853,0,0,0,786.0,786.0
022188145144,150854,0,0,0,786.0,786.0
022188145151,150855,0,0,0,786.0,786.0
022188147827,150908,0,0,0,785.0,785.0
022188147810,150909,0,0,0,785.0,785.0
022188145359,150972,68,53,121,615.0,615.0
022188602210,160221,0,0,0,657.0,657.0
022188602289,160228,23,6,29,657.0,657.0
022188604108,160410,0,0,0,729.0,729.0
022188605785,160578,0,0,0,751.0,751.0
022188605846,160584,0,0,0,751.0,751.0
022188620696,162069,0,0,0,769.0,769.0
022188624106,162410,0,0,0,782.0,782.0
022188624144,162414,0,0,0,657.0,657.0
022188624205,162420,0,0,0,631.0,631.0
022188624304,162430,0,0,0,657.0,657.0
022188626346,162634,0,0,0,670.0,670.0
022188626629,162662,0,0,0,769.0,769.0
022188628104,162810,41,23,64,418.0,418.0
022188630503,163050,68,47,115,418.0,418.0
022188630527,163052,28,19,47,615.0,615.0
022188630626,163062,3,0,3,887.0,887.0
022188630640,163064,0,0,0,887.0,887.0
022188630701,163070,10,36,46,418.0,418.0
022188634143,163414,0,0,0,1041.0,1041.0
022188634600,163460,0,0,0,1268.0,1268.0
022188634655,163465,0,0,0,1268.0,1268.0
022188635003,163500,0,0,0,1213.0,1213.0
022188635010,163501,0,0,0,1268.0,1268.0
022188635041,163504,0,0,0,1268.0,1268.0
022188636031,163603,0,0,0,848.0,848.0
022188636062,163606,0,0,0,848.0,848.0
022188636369,163636,0,0,0,889.0,889.0
022188636383,163638,0,0,0,889.0,889.0
022188636901,163690,0,0,0,630.0,630.0
022188638080,163808,26,25,51,445.0,445.0
022188638103,163810,53,19,72,417.0,417.0
022188638110,163811,16,27,43,615.0,615.0
022188641929,164192,0,0,0,769.0,769.0
022188641943,164194,0,0,0,769.0,769.0
022188641981,164198,0,0,0,769.0,769.0
022188642223,164222,0,0,0,751.0,751.0
022188642247,164224,0,0,0,751.0,751.0
022188643008,164300,0,0,0,769.0,769.0
022188701333,170133,0,0,0,1012.0,1012.0
022188701357,170135,0,0,0,1012.0,1012.0
022188701708,170170,0,0,0,1147.0,1147.0
022188702101,170210,0,0,0,1176.0,1176.0
022188702316,170231,0,0,0,1506.0,1506.0
022188702453,170245,0,0,0,1226.0,1226.0
022188702620,170262,0,0,0,1531.0,1531.0
022188702699,170269,0,0,0,1239.0,1239.0
022188702927,170292,0,0,0,1211.0,1211.0
022188702965,170296,0,0,0,1462.0,1462.0
022188702996,170299,0,0,0,1488.0,1488.0
022188703184,170318,0,0,0,1284.0,1284.0
022188703191,170319,0,0,0,1343.0,1343.0
022188703207,170320,0,0,0,1449.0,1449.0
022188703238,170323,0,0,0,1523.0,1523.0
022188703399,170339,0,0,0,1470.0,1470.0
022188703412,170341,0,0,0,1167.0,1167.0
022188703436,170343,0,0,0,1427.0,1427.0
022188703443,170344-SW,0,0,0,1427.0,1427.0
022188703467,170346,0,0,0,1054.0,1054.0
022188703481,170348,11,6,17,493.0,493.0
022188703498,170349,23,21,44,493.0,493.0
022188703504,170350,0,0,0,1576.0,1576.0
022188780116,178011,0,0,0,1342.0,1342.0
022188780123,178012,0,0,0,905.0,905.0
022188780130,178013,0,0,0,703.0,703.0
022188780147,178014,0,0,0,905.0,905.0
022188780178,178017,13,1,14,1453.0,1453.0
022188780208,178020,9,2,11,1125.0,1125.0
022188780314,178031,0,0,0,1453.0,1453.0
022188780383,178038,0,0,0,936.0,936.0
022188780413,178041,14,7,21,447.0,447.0
022188780420,178042,24,20,44,447.0,447.0
022188780444,178044,0,0,0,736.0,736.0
022188780475,178047,11,8,19,1481.0,1481.0
022188869026,178053,3,3,6,1271.0,1271.0
022188780550,178055,0,0,0,1131.0,1131.0
022188867244,180022,65,21,86,401.0,401.0
022188872934,180023,99,99,198,361.0,361.0
022188147223,187020,0,24,24,406.0,406.0
022188147230,187021,0,99,99,406.0,406.0
022188149333,223400,37,16,53,327.0,327.0
022188149326,223900,36,5,41,327.0,327.0
022188864144,10057,0,0,0,1775.0,1775.0
022188866421,10159-SW,99,64,163,629.0,629.0
022188868104,10202,78,41,119,650.0,650.0
022188868111,10203,8,4,12,650.0,650.0
022188868265,10205,4,4,8,623.0,623.0
022188868227,10206,0,84,84,388.0,388.0
022188868210,10207,4,5,9,388.0,388.0
022188868203,10208-SW,99,58,157,388.0,388.0
022188868258,10210,57,38,95,439.0,439.0
022188868395,10211,0,0,0,439.0,439.0
022188868388,10212,20,24,44,439.0,439.0
022188868241,10213,66,20,86,439.0,439.0
022188868142,11507,4,8,12,623.0,623.0
022188869897,11532,50,3,53,945.0,945.0
022188869187,11616,38,55,93,650.0,650.0
022188872729,12001-SW,0,99,99,656.0,656.0
022188873733,12055,0,99,99,637.0,637.0
022188873740,12066,31,15,46,439.0,439.0
022188880137,12490,12,10,22,960.0,960.0
022188892512,12575,0,0,0,512.0,512.0
022188879193,12722,36,23,59,403.0,403.0
022188879414,12723,0,5,5,403.0,403.0
022188879421,12724,12,7,19,403.0,403.0
022188879643,12936,27,1,28,667.0,667.0
022188879667,12938,0,9,9,675.0,675.0
022188887693,13507,99,20,119,795.0,795.0
022188888003,13508,2,0,2,791.0,791.0
022188888010,13509,0,2,2,800.0,800.0
022188888027,13510,42,30,72,793.0,793.0
022188888034,13511-SW,0,5,5,809.0,809.0
022188887884,13512,0,4,4,814.0,814.0
022188887921,13513,9,3,12,858.0,858.0
022188887914,13514-SW,0,2,2,894.0,894.0
022188888713,13515,27,3,30,1243.0,1243.0
022188888102,13516,1,0,1,1243.0,1243.0
022188887938,13517,4,8,12,1265.0,1265.0
022188888317,13518,11,5,16,1243.0,1243.0
022188888300,13519,5,2,7,1265.0,1265.0
022188887792,13520-SW,4,3,7,1356.0,1356.0
022188887785,13521,4,4,8,1356.0,1356.0
022188490503,19050,19,35,54,24.99,21.99
022188491104,19110,20,73,93,27.99,24.99
022188127911,194410000,30,70,100,34.99,28.99
022188127935,194390000,18,38,56,34.99,28.99
022188127942,194400000,80,99,179,34.99,28.99
022188127928,194420000,72,44,116,34.99,28.99
022188131840,19453,5,13,18,34.99,29.99
022188131833,19454,20,32,52,34.99,29.99
022188132373,19455,13,18,31,34.99,28.99
022188131857,19456,1,45,46,34.99,28.99
022188132397,19462-SW,1,44,45,34.99,28.99
022188132380,19463,98,30,128,34.99,28.99
022188132755,19469-SW,22,20,42,34.99,28.99
022188132762,19470,10,16,26,34.99,28.99
022188135008,194760000,24,26,50,40.99,36.99
022188134995,19477,22,40,62,40.99,29.99
022188141443,19491,27,48,75,34.99,22.99
022188141450,19492,42,46,88,34.99,19.99
022188141603,19922,99,99,198,19.99,17.99
022188143379,19923,19,30,49,19.99,17.99
022188143362,19924,0,34,34,19.99,17.99
022188144291,199250000,0,0,0,34.99,
022188144307,19926,48,44,92,34.99,28.99
022188144314,19927,23,21,44,34.99,28.99
022188144321,19928,17,22,39,34.99,28.99
022188149500,19929,99,99,198,19.99,17.99
022188144482,19930,49,99,148,18.99,16.49
022188149579,199330000,0,17,17,31.99,28.99
022188149562,199340000,4,23,27,31.99,28.99
022188200652,199350000,40,50,90,31.99,27.99
022188149586,199360000,58,81,139,31.99,27.99
022188866018,3000247,0,25,25,34.99,29.99
022188865103,3000898,66,61,127,27.99,24.99
022188866001,3001439,7,8,15,28.99,24.99
022188868302,3001520,21,55,76,27.99,24.99
022188866025,3001765,26,27,53,28.99,24.99
022188869507,3005566,29,6,35,31.99,28.99
022188869514,3005567,20,50,70,31.99,28.99
022188870527,3007345,95,99,194,40.99,33.99
022188870602,3007346,7,1,8,40.99,36.99
022188874280,3008590,32,44,76,34.99,28.99
022188874297,3008591,14,51,65,34.99,28.99
022188875188,3008882,0,23,23,26.99,24.99
022188874815,3009876,17,16,33,31.99,28.99
022188874648,3009877,4,42,46,31.99,28.99
022188878615,3011499,83,0,83,32.99,28.99
022188882735,3012704,0,24,24,27.99,24.99
022188892536,3015716,16,20,36,37.99,32.99
022188884289,3012992,60,38,98,,
022188886818,3014410,29,0,29,31.99,28.99
022188886825,3014411,99,84,183,31.99,28.99
022188890310,3015282,86,91,177,33.99,29.99
022188890501,3015318,8,25,33,31.99,28.99
022188890518,3015319,99,78,177,31.99,28.99
022188890525,3015320,99,99,198,31.99,28.99
022188892543,3015717,99,99,198,37.99,33.99
022188893502,3015890,99,99,198,31.99,28.99
022188893762,3015896,99,99,198,35.99,32.99
022188146493,42250,20,25,45,27.99,24.99
022188146509,42251,15,51,66,27.99,24.99
022188150704,432170000,0,14,14,31.99,28.99
022188200676,432180000,13,29,42,31.99,28.99
661120412687,1078425,0,0,0,7.49,
661120414247,1084758,10,7,17,34.99,
661120412649,1085634,0,5,5,64.99,
661120000105,110013,3,4,7,48.99,
661120000112,110014,99,0,99,27.99,
661120000181,110019,0,3,3,8.99,
661120000198,110020,0,0,0,10.99,
661120000228,110023,7,2,9,67.99,
661120000242,110025,2,4,6,67.99,
661120000273,110028,1,0,1,18.99,
661120000280,110029,0,0,0,22.99,
661120000297,110030,0,0,0,18.99,
661120001287,110116,38,39,77,19.99,
661120001706,110155,9,6,15,14.99,
661120001904,110175,11,0,11,24.99,
022188864823,10048-LE,35,0,35,374.0,374.0
022188093810,109381-LE,0,32,32,315.0,315.0
022188869262,11518-LE,2,0,2,469.0,
022188869286,11519-LE,2,1,3,469.0,
022188869217,11520-LE,1,1,2,490.0,
022188869057,11537-LE,0,1,1,502.0,502.0
022188872699,11675-LE,1,7,8,448.0,
022188872750,11677-LE,6,2,8,448.0,
022188874389,11788,47,0,47,740.98,549.99
022188874341,11797,19,22,41,714.98,514.99
022188872187,11808,0,0,0,400.98,299.99
022188873580,11870,99,57,156,539.98,419.99
022188871135,11882-LE,3,0,3,408.0,
022188874419,12097-LE,0,0,0,394.0,
022188890655,13645,50,40,90,499.0,429.99
022188887563,13492,0,0,0,1097.98,847.98
022188150902,311024-LE,3,9,12,1135.0,
022188150896,311041-LE,4,5,9,843.0,
022188150285,811308,58,7,65,1383.0,1283.0
661120412168,1078454,0,10,10,24.99,
022188871111,11883-LE,6,2,8,,
022188871104,11884-LE,0,1,1,,
022188884746,13353-LE,0,0,0,,
022188890921,13613-LE,0,0,0,,
022188890532,13614-LE,0,0,0,,
022188890549,13615-LE,0,0,0,,
022188890556,13616-LE,0,0,0,,
022188890563,13617-LE,0,0,0,,
022188890570,13618-LE,0,0,0,,
022188890587,13619-LE,0,0,0,,
022188893311,13769-LE,0,0,0,,
022188893533,13787-LE,0,0,0,,
022188893335,13790-LE,0,0,0,,
022188893342,13792-LE,0,0,0,,
022188893359,13794-LE,0,0,0,,
022188893366,13795-LE,0,0,0,,
022188893380,13796-LE,0,0,0,,
022188893571,13808-LE,0,0,0,,
022188894011,13900-LE,0,0,0,,
022188894172,13902-LE,0,0,0,,
022188894257,13917-LE,0,0,0,,
022188894035,13920-LE,0,0,0,,
022188147223,187020-LE,0,45,45,406.0,406.0
022188147230,187021-LE,0,0,0,406.0,406.0
022188869385,11600-LE,0,0,0,,
022188881905,13073-LE,0,0,0,,
022188893625,13781-LE,0,0,0,,
022188150933,311308-LE,11,12,23,,
022188893182,13772,0,0,0,,
022188884982,13351-LE,0,0,0,,
022188884227,13317,99,49,148,459.99,449.99
022188884715,13344,68,36,104,349.99,349.0
022188890938,13625,0,0,0,588.0,588.0
022188890723,13642,29,79,108,459.99,449.99
022188893120,13711-SW,78,8,86,495.0,495.0
022188892659,13712-SW,99,3,102,667.0,667.0
022188893113,13729,99,71,170,439.0,439.0
729857011457,12-21-02-57,42,23,65,,
729857993975,B61N-CP,0,0,0,,
729857994002,B66N-CP,0,0,0,,
729857006392,PA1001-CP,35,20,55,,
729857009003,PA1002-CP,30,16,46,,
729857007917,PP1001-CP,59,35,94,,
729857011075,11-41-04-41,26,19,45,,
729857011112,11-41-06-41,11,17,28,,
729857013406,11-41-09-41,25,13,38,,
729857010054,12-27-01-57,30,15,45,,
729857010061,12-27-02-57,55,33,88,,
729857011471,12-27-03-57,23,6,29,,
729857011488,12-27-04-57,36,22,58,,
729857010092,12-57-01-57,22,15,37,,
729857010139,12-61-01-57,26,8,34,,
729857010191,12-63-01-57,9,20,29,,
729857011679,15-38-01-57,44,25,69,,
729857011662,15-38-02-57,42,24,66,,
729857011693,15-38-03-57,45,28,73,,
729857011686,15-38-04-57,50,30,80,,
729857011747,15-38-07-57,32,12,44,,
729857011730,15-38-08-57,31,14,45,,
729857011761,15-38-09-57,32,19,51,,
729857011754,15-38-10-57,32,18,50,,
729857011549,15-61-01-57,64,3,67,,
729857011556,15-61-02-57,31,5,36,,
729857013369,15-73-01-57,0,0,0,,
729857013376,15-73-02-57,0,0,0,,
729857010047,17-21-02-57,23,15,38,,
729857011501,17-61-01-57,35,21,56,,
729857011518,17-61-02-57,36,19,55,,
729857011525,17-61-03-57,35,21,56,,
729857011532,17-61-04-57,34,22,56,,
729857008945,23-125-01-43,17,11,28,,
729857007955,ACE1001-CP,55,31,86,,
729857993982,B63N-CP,0,0,0,,
729857007030,CE1012-CP,26,37,63,,
729857006361,CH1001-CP,80,32,112,,
729857994781,E37SN-CP,11,4,15,,
729857991506,E37T-K,15,6,21,,
729857994309,EL01-CP,29,39,68,,
729857994859,F01TN-CP,84,34,118,,
729857002417,F041TN-CP,16,3,19,,
729857995122,F06TN-CP,80,34,114,,
729857993296,F08-N,45,17,62,,
729857002660,F182N-CP,52,13,65,,
729857996631,FF25-CP,64,19,83,,
729857006378,FK1001-CP,53,27,80,,
729857007887,FLA1001-CP,61,49,110,,
729857998932,FX41N-CP,86,36,122,,
729857004336,GB1001-CP,45,10,55,,
729857996754,JB01K-CP,27,14,41,,
729857999274,KEY-101,32,45,77,,
729857999434,KEY-102-CP,42,34,76,,
729857994767,M37N-CP,46,22,68,,
729857002455,NB1002-CP,31,23,54,,
729857002479,NB1012-CP,58,34,92,,
729857002530,SK1001-CP,84,25,109,,
729857002516,SS1003-CP,45,14,59,,
729857002486,TH1001-CP,46,30,76,,
729857998758,TWI17-CP,80,49,129,,
729857006583,UF1001-BX,20,15,35,,
812449021627,PCDS1,0,0,0,,
812449020606,SBBL2BK,36,18,54,,
812449021054,SBBL3BK,0,0,0,,
812449022525,SBSL002BKBK,68,17,85,,
812449022518,SBSL002BKGR,44,6,50,,
812449022501,SBSL003BKBK,42,15,57,,
812449022495,SBSL003BKGR,58,26,84,,
812449022471,SBSL004BKBK,55,36,91,,
812449022488,SBSL004BKGR,33,31,64,,
812449021542,SBSL005BK,0,0,0,,
812449021559,SBSL006BK,0,0,0,,
812449020590,SFBL7BK,70,35,105,,
812449020170,SFBL7GR,27,34,61,,
812449020125,SFBL8CF,74,24,98,,
812449020132,SFBL8GR,17,32,49,,
812449020637,SFBL9BK,46,13,59,,
706397861230,XD0932,0,5,5,32.99,
706397929466,HC9319B,3,16,19,463.0,
706397943943,HC9319BLC,36,22,58,463.0,
706397929480,HC9319BOSP,41,42,83,490.0,
706397943950,HC9319BOSPLC,0,5,5,490.0,
706397934736,HC9319BOSPMS,73,35,108,490.0,
706397932114,HC9319BOSPSMSC,21,9,30,652.0,
706397933944,HC9319F,51,38,89,498.0,
706397933951,HC9319FOSP,24,8,32,524.0,
706397966003,HC9319REBS,99,99,198,519.99,
706397966072,HC9319REBSOSP,99,99,198,539.99,
706397943462,HC9389BTOSP,7,32,39,602.0,
706397943479,HC9389BTOSPMS,31,4,35,602.0,
706397947453,HC9389BTOSPSMMS,12,15,27,760.0,
706397947446,HC9389BTOSPSMSC,20,9,29,760.0,
706397956578,HCP9379BOSP,99,99,198,502.0,
706397962746,HCP9379BOSPSMSC,52,27,79,664.0,
706397966096,HCP9379FOSP,99,99,198,535.0,
706397966089,HCP9379REBSOSP,99,99,198,554.99,
706397943967,HP9201,0,0,0,618.0,
706397913120,PB9108LCA,0,0,0,682.0,
706397913137,PB9151LCA,0,0,0,708.0,
706397926588,PBD9108L,0,0,0,561.0,
706397919498,PC9105LCA18,0,0,0,1406.0,
706397919511,PC9107LCA18,0,0,0,1339.0,
706397919535,PC9108LCA18,0,0,0,1339.0,
706397964467,PH9117AOS,0,0,0,1160.0,
706397964733,PH9117AOSD,0,0,0,1315.0,
706397964474,PH9119AOS,0,0,0,1160.0,
706397964740,PH9119AOSD,0,0,0,1315.0,
706397913175,PI9134LCA,0,0,0,865.0,
706397913113,PI9209LCA,0,0,0,1016.0,
706397944018,PO9230,0,0,0,916.0,
706397919597,PX9105MLCA18,0,0,0,1063.0,
706397913144,PX9109LCA,0,0,0,773.0,
706397929626,PX9117L,0,0,0,709.0,
706397929633,PX9118L,0,0,0,709.0,
706397930134,PX9119L,0,0,0,709.0,
706397930141,PX9120L,0,0,0,709.0,
706397930325,PX9121L,0,0,0,709.0,
706397937690,PX9123L,0,0,0,709.0,
706397937706,PX9124L,0,0,0,709.0,
706397913151,PX9151LCA,0,0,0,816.0,
706397934514,PX9217L,0,0,0,1065.0,
706397934507,PX9218L,0,0,0,1065.0,
706397934484,PX9219L,0,0,0,1065.0,
706397934491,PX9220L,0,0,0,1065.0,
706397943608,PX9419,33,34,67,671.0,
706397943592,PX9419S,0,0,0,709.0,
706397943578,PX9420,0,0,0,671.0,
706397943585,PX9420S,0,0,0,709.0,
706397161019,XD9101,0,51,51,418.0,
706397161026,XD9102,0,14,14,418.0,
706397163013,XD9301,0,22,22,452.0,
706397163020,XD9302,0,99,99,452.0,
706397164010,XD9401,0,5,5,457.0,
706397164027,XD9402,0,36,36,457.0,
706397866129,XD9611,12,18,30,437.0,
706397866594,XD9621,0,7,7,482.0,
706397900014,XD9645,2,5,7,458.0,
706397168018,XD9801,0,45,45,418.0,
706397168025,XD9802,0,4,4,418.0,
706397926014,XDD9101,14,14,28,340.0,
706397926021,XDD9101HC,14,5,19,340.0,
706397926045,XDD9801,3,5,8,340.0,
706397926038,XDD9801HC,5,4,9,340.0,
706397952716,XE93810CBHCOSPD,0,0,0,647.0,
706397952495,XME93810CBHCOSP,5,0,5,505.0,
706397951832,XDM93845CBHCOSP,17,7,24,505.0,
706397956400,XD93845CBHCOSPD,14,6,20,647.0,
706397932442,XDME9389BHC,21,0,21,471.0,
706397943424,XDME9389CBHCOSP,80,22,102,505.0,
706397945589,XDM9389CBHCOSPD,99,0,99,647.0,
706397961251,XDME94510BHCOSP,42,33,75,505.0,
706397961725,XME94510BHCOSPD,25,14,39,647.0,
706397932459,XDME9459BHC,0,0,0,471.0,
706397932527,XDMET9459BHCOSP,21,5,26,566.0,
706397932497,XDMET9459FHCOSP,0,0,0,566.0,
706397955069,XDSG93345BCT,0,0,0,439.0,
706397950743,XDSG93345BOSP,0,0,0,360.0,
706397941185,XDSG9339BCT,16,6,22,439.0,
706397935795,XDSG9339BOSP,16,11,27,340.0,
706397041229,AA9122,0,0,0,1614.0,
706397041267,AA9126,0,0,0,1502.0,
706397904074,AA9611,0,0,0,1741.0,
706397926748,AA9622,0,0,0,1614.0,
706397852665,AA9626,0,0,0,1614.0,
706397939373,BAW920308CFD,25,18,43,2010.0,
706397939458,BAW920308CFDA,8,3,11,2065.0,
706397939137,BAW920308CFG,7,2,9,2010.0,
706397939465,BAW920308CFGA,12,8,20,2065.0,
706397939380,BAW920308D,0,0,0,1681.0,
706397939601,BAW920308DA,0,0,0,1736.0,
706397939120,BAW920308G,0,0,0,1681.0,
706397939472,BAW920308GA,0,0,0,1736.0,
706397939397,BAW9206CMCFD,4,4,8,2010.0,
706397939489,BAW9206CMCFDA,0,0,0,2065.0,
706397939199,BAW9206CMCFG,7,3,10,2010.0,
706397939496,BAW9206CMCFGA,0,0,0,2065.0,
706397939403,BAW9206CMD,0,0,0,1681.0,
706397939502,BAW9206CMDA,0,0,0,1736.0,
706397939182,BAW9206CMG,0,0,0,1681.0,
706397939519,BAW9206CMGA,0,0,0,1736.0,
706397939410,BAW92265CMCFD,0,0,0,2010.0,
706397939526,BAW92265CMCFDA,0,0,0,2065.0,
706397939175,BAW92265CMCFG,38,35,73,2010.0,
706397939533,BAW92265CMCFGA,0,0,0,2065.0,
706397939427,BAW92265CMD,29,19,48,1681.0,
706397939540,BAW92265CMDA,2,3,5,1736.0,
706397939168,BAW92265CMG,37,28,65,1681.0,
706397939557,BAW92265CMGA,1,3,4,1736.0,
706397939434,BAW92465PRCCFD,24,8,32,2010.0,
706397939564,BAW92465PRCCFDA,7,10,17,2065.0,
706397939151,BAW92465PRCCFG,31,25,56,2010.0,
706397939571,BAW92465PRCCFGA,19,11,30,2065.0,
706397939441,BAW92465PRCD,0,0,0,1681.0,
706397939588,BAW92465PRCDA,0,0,0,1736.0,
706397939144,BAW92465PRCG,0,0,0,1681.0,
706397939595,BAW92465PRCGA,0,0,0,1736.0,
706397956776,HL916556B,99,40,139,1546.0,
706397011024,MA9102-5,0,0,0,1451.0,
706397019020,MA9102CA,0,0,0,1451.0,
706397011062,MA9106-5,0,0,0,1370.0,
706397019068,MA9106CA,0,0,0,1370.0,
706397900106,MA9120,0,0,0,1370.0,
706397012229,MA9222,0,0,0,1594.0,
706397019228,MA9222CA,0,0,0,1594.0,
706397012267,MA9226,0,0,0,1499.0,
706397019266,MA9226CA,0,0,0,1499.0,
706397916985,MA9826C65CA,0,0,0,1614.0,
706397900793,MP9220,0,0,0,1628.0,
706397900755,MP9226,0,0,0,1628.0,
706397916961,MP9820C65,0,0,0,1662.0,
706397916022,MP9826C65,0,0,0,1662.0,
706397935504,ST916556B-B5,9,3,12,791.0,
706397926410,ST916556BM,3,0,3,791.0,
706397927110,ST916556BMACA-S,0,7,7,791.0,
706397927080,ST916556BMCA-S,0,5,5,791.0,
706397926427,ST916556BMLC,1,0,1,791.0,
706397913649,STE916556B,6,0,6,1066.0,
706397952723,STV91609B,99,99,198,1005.0,1005.0
706397926304,STV916308B,0,0,0,1158.0,
706397927905,STV916308BLC,0,0,0,1158.0,
706397925505,STV916556B,0,0,0,890.0,
706397935511,STV916556B-B5,0,0,0,890.0,
706397925987,STV916556BCA,0,21,21,890.0,
706397940621,ARS6032,99,66,165,28.99,
706397941826,HC5910,89,0,89,22.99,
706397929473,HC5911,3,44,47,22.99,
706397931247,HC5913,0,8,8,32.99,
706397940324,HC5915,0,0,0,32.99,
706397941857,HC5915F,0,0,0,32.99,
706397958626,HCP5915,0,0,0,32.99,
706397250065,MA5006,0,0,0,32.99,
706397860578,MA5021,0,0,0,41.99,
706397917654,PG6806,3,11,14,20.99,
706397921088,PG6906,0,0,0,20.99,
706397943509,PH6917,0,0,0,33.99,
706397943516,PH6920,0,0,0,33.99,
706397943899,PH6926,0,0,0,33.99,
706397645236,PI4523,0,0,0,13.99,
706397851804,PI4726,6,4,10,17.99,
706397901141,PI6069,0,0,0,22.99,
706397867287,PI6070,0,0,0,22.99,
706397873868,PI6074,0,0,0,33.99,
706397854492,PI6083,0,0,0,32.99,
706397850722,XD0923,0,0,0,22.99,
706397861223,XD0931,0,0,0,32.99,
706397862015,XD0933,0,0,0,32.99,
706397850739,XD0940,0,0,0,22.99,
706397850753,XD1923,6,38,44,22.99,
706397877033,XD1924,24,35,59,22.99,
706397854706,XD1940,5,0,5,22.99,
706397891329,XD4500,1,3,4,23.99,
706397867034,XD4510,0,0,0,23.99,
706397866747,XD4545,8,8,16,23.99,
706397891633,XD45451,0,0,0,34.99,
706397859152,XD5011,3,5,8,22.99,
706397860639,XD5016,1,10,11,22.99,
706397914042,XDE0908,3,18,21,26.99,
706397914158,XDE50071,0,0,0,32.99,
706397900748,XDG4546,10,0,10,32.99,
706397877187,XDM5011,0,0,0,26.99,
706397921712,XDM5015,7,66,73,26.99,
706397882457,XDM5019,97,15,112,26.99,
706397930042,XDME5914,99,99,198,26.99,
706397930004,XDME5922,0,0,0,26.99,
706397952730,XDME5935,15,5,20,40.99,
706397895761,XDS09061,0,0,0,32.99,
706397893941,XDS0907,0,0,0,22.99,
706397920043,XDS0907H,0,3,3,22.99,
706397897918,XDS0908,8,16,24,32.99,
706397905835,XDS4007,0,0,0,32.99,
706397892845,XDS5005,0,0,0,22.99,
706397897901,XDS5006,0,2,2,32.99,
706397892883,XDS50071,0,4,4,32.99,
706397926564,XDSG04071,8,9,17,32.99,
706397921583,XDSG09061,0,2,2,32.99,
706397917869,XDSG0908,1,4,5,32.99,
706397927929,XDSG4006H,10,10,20,22.99,
706397250508,MA5050,0,0,0,65.99,
706397886400,MA4GENAM,3,5,8,139.99,
706397885120,MA5028,2,2,4,264.99,
706397945510,STA918223B,7,2,9,1198.0,
706397956288,STAE918223CB,2,10,12,1470.0,
706397897796,XD9611HC,0,0,0,424.0,
706397919085,XDSG9339S,0,0,0,406.0,
,SAR4C2,0,0,0,,
866281000395,1911B,0,0,0,999.99,
854581007152,1911B1,0,0,0,1219.99,
854581007107,1911CC,0,0,0,1199.99,
854581007114,1911CC1,0,0,0,1499.99,
854581007015,S333,2,0,2,339.99,
854581007121,SA4CC,0,0,0,1799.99,
854581007138,SA5CC,0,0,0,1759.99,
854581007930,SAP22B,0,0,0,,
,SAP22BE,0,0,0,,
854581007954,SAP22C,0,0,0,,
854581007978,SAP22CE,0,0,0,,
854581007824,SWITCH-GUN,0,0,0,369.99,
869481000103,DP12,5,3,8,1239.99,
869481000172,DP12FDE,4,2,6,1239.99,
854581007183,DP12FDECA,3,1,4,1239.99,
869481000189,DP12ODG,1,1,2,1239.99,
854581007176,DP12ODGCA,1,1,2,1239.99,
866281000388,SKOBLK,2,2,4,769.99,
854581007381,SKOMBLK,1,1,2,619.99,
854581007220,SKOSBLK,0,0,0,619.99,
854581007893,SP12,1,1,2,564.99,
854581007909,SP12-COMPACT,8,0,8,564.99,
854581007251,SKO-02102-10,10,14,24,56.99,
854581007701,16721,0,0,0,899.99,
011356192523,19252,24,5,29,184.99,
011356192530,19253,0,2,2,184.99,174.99
011356194855,19485,8,2,10,217.99,
011356194862,19486,4,0,4,217.99,
011356194893,19489,0,0,0,217.99,214.99
011356194909,19490,0,0,0,249.99,
011356194954,19495,7,3,10,244.99,
011356194961,19496,8,3,11,256.99,
011356221544,22154,0,0,0,609.99,
011356221551,22155,0,0,0,609.99,
011356221568,22156,0,3,3,609.99,
011356221650,22165,0,6,6,609.99,
011356221667,22166,0,0,0,609.99,
011356221674,22167,0,0,0,609.99,
011356221681,22168,4,1,5,609.99,
011356221780,22178,0,0,0,609.99,
011356221797,22179,0,1,1,749.99,
011356224361,22436,5,18,23,217.99,214.99
011356224378,22437,0,0,0,217.99,214.99
011356224385,22438,10,8,18,217.99,
011356224392,22439,15,6,21,244.99,
011356225603,22560,0,0,0,254.99,
011356225610,22561,0,0,0,254.99,
011356225627,22562,98,9,107,254.99,244.99
011356225634,22563,78,24,102,254.99,244.99
011356225641,22564,38,5,43,259.99,249.99
011356225924,22592,0,0,0,749.99,
011356225931,22593,0,7,7,749.99,
011356225955,22595,0,0,0,749.99,
011356232168,23216-SAV,0,0,0,214.99,204.99
011356232182,23218-SAV,0,0,0,214.99,204.99
011356232199,23219,0,0,0,214.99,
011356232205,23220,0,0,0,214.99,204.99
011356232212,23221,0,0,0,194.99,184.99
011356232229,23222,0,0,0,609.99,
011356232236,23223,1,0,1,609.99,
011356232243,23224,0,0,0,609.99,
011356232472,23247,6,5,11,229.99,
011356232502,23250,12,0,12,274.99,264.99
011356232519,23251,15,3,18,274.99,264.99
011356573803,57380,36,0,36,614.99,
011356573810,57381,0,0,0,709.99,
011356232250,23225,4,15,19,589.99,
858426004214,ANKLEBITER,10,5,15,22.99,
859640007210,BELLYBAND-LRG,0,0,0,23.49,
859640007203,BELLYBAND-MED,1,6,7,23.49,
859640007197,BELLYBAND-SM,8,1,9,23.49,
859640007241,COMFORT-PAD-LRG,2,2,4,12.49,
859640007234,COMFORT-PAD-MED,2,0,2,12.49,
858426004528,GUARDHERBELT-LG,1,11,12,17.99,
858426004252,GUARDHERBELT-MD,3,4,7,17.99,
858426004245,GUARDHERBELT-SM,4,3,7,,
858426004108,LG-1L,3,22,25,17.99,
858426004092,LG-1S,52,0,52,17.99,
858426004115,LG-2,24,18,42,17.99,
858426004122,LG-3,9,6,15,17.99,
858426004153,LG-6S,34,3,37,17.99,
858426004436,LG-6S-MOD,7,3,10,17.99,
858426004030,MD-1,25,25,50,17.99,
858426004047,MD-2,20,15,35,17.99,
858426004054,MD-3,0,20,20,17.99,
858426004061,MD-4,0,21,21,17.99,
858426004733,MD-4-GEN1,25,6,31,17.99,
858426004764,MD-4-GEN1-MOD,19,23,42,17.99,
858426004429,MD-4-MOD,0,17,17,17.99,15.99
858426004078,MD-5,24,23,47,17.99,
859640007340,OR-3,7,0,7,,
859640007364,OR-5,22,0,22,,
859640007388,OR-7,14,5,19,23.99,
858426004009,SM-1,3,19,22,17.99,
858426004016,SM-2,12,15,27,17.99,
858426004023,SM-3,24,7,31,17.99,
858426004962,SM-5,34,26,60,17.99,
859640007005,SM-5-MOD,28,24,52,17.99,
858426004184,SMP-2,0,10,10,17.99,
858426004412,STM,10,1,11,23.49,
080926666016,66601,23,22,45,29.99,
080926449312,44931,9,6,15,,
080926449565,44956,10,5,15,,
080926663206,66320,13,13,26,50.99,
080926666054,66605,48,36,84,29.99,
080926666061,66606,47,36,83,29.99,
080926691100,69110,12,22,34,124.99,
080926692107,69210,11,6,17,127.99,
080926692602,69260,85,99,184,147.99,128.99
080926692619,69261,4,1,5,329.99,
080926692626,69262,21,7,28,184.99,
080926692640,69264,20,17,37,147.99,
080926692664,69266,8,6,14,154.99,
080926692671,69267,6,4,10,154.99,
080926692701,69270,58,6,64,105.99,
080926692732,69273,13,5,18,105.99,
080926692770,69277,10,12,22,127.99,
080926692831,69283,6,6,12,74.99,
080926692848,69284,11,2,13,105.99,
080926692855,69285,9,4,13,74.99,
080926692862,69286,11,12,23,105.99,
080926692879,69287,3,5,8,105.99,
080926692886,69288,6,4,10,105.99,
080926694002,69400,8,20,28,127.99,
080926694019,69401,9,15,24,127.99,
080926694026,69402,0,2,2,127.99,
080926694040,69404,6,11,17,127.99,
080926694101,69410,0,0,0,207.99,
080926694118,69411,3,4,7,195.99,
080926694149,69414,6,10,16,207.99,
080926694170,69417,5,4,9,195.99,
080926694187,69418,4,1,5,195.99,
080926694194,69419,5,5,10,195.99,
080926694248,69424,0,0,0,127.99,
080926694293,69429,0,0,0,134.99,
080926694316,69431,30,32,62,239.99,
080926694347,69434,4,9,13,254.99,
080926694378,69437,2,2,4,239.99,
080926694385,69438,2,2,4,239.99,
080926694392,69439,6,5,11,239.99,
080926694408,69440,0,18,18,144.99,
080926694439,69443,9,11,20,276.99,
080926694477,69447,0,3,3,234.99,
080926694507,69450,11,1,12,152.99,
080926694514,69451,7,5,12,127.99,
080926694538,69453,2,2,4,288.99,
080926694644,69464,4,5,9,135.99,
080926694736,69473,5,4,9,269.99,
080926696006,69600,23,23,46,127.99,
080926696013,69601,0,2,2,127.99,
080926730021,73002,30,35,65,7.99,5.99
080926730038,73003,24,0,24,7.99,
080926733008,73300-SLI,31,22,53,19.99,
080926733015,73301,31,33,64,19.99,
080926733022,73302,31,33,64,19.99,
080926733039,73303,18,24,42,19.99,
080926746114,74611,0,6,6,139.99,
080926880597,88059,20,24,44,112.99,
080926880610,88061,14,12,26,40.99,
080926880665,88066,0,0,0,118.99,
080926880818,88081,21,23,44,104.99,
080926880825,88082,5,6,11,59.99,
080926880849,88084,3,6,9,88.99,
080926888104,88810,23,22,45,84.99,
080926888111,88811,21,20,41,84.99,
080926890008,89000-SLI,5,4,9,98.99,
080926661493,66149,0,0,0,59.99,
852237007365,ARH300,72,41,113,134.99,109.99
852237007366,ARH400-L,16,15,31,147.99,
852237007367,ARH400-R,13,10,23,147.99,
985684578659,100672,22,12,34,,
796430000634,100063,2,2,4,132.99,132.99
796430000658,100065,13,2,15,124.99,119.99
796430000665,100066,15,13,28,31.99,
796430000672,100067,34,32,66,31.99,24.99
796430000689,100068,15,11,26,314.99,299.99
796430002454,100245,85,59,144,124.99,119.99
811192033024,30051,7,0,7,,
796430372151,37215,35,60,95,36.99,29.99
796430390667,39066,17,16,33,224.99,214.99
796430000641,100064,23,23,46,37.99,
796430221985,22198-TAS,0,3,3,59.99,54.99
725327605430,1-191101-B1,74,50,124,564.99,
725327611233,1-191101FS,1,6,7,499.99,
725327601036,1-191109,28,4,32,614.99,
725327600527,1-920151-17,32,30,62,439.99,
725327616122,1-G2C4031-10,0,0,0,219.99,
725327931966,1-G2C931-10,0,0,0,219.99,
725327616030,1-G2C931-12,0,0,0,219.99,
725327616054,1-G2C931-12G,0,12,12,219.99,
725327931973,1-G2C939-10,0,0,0,234.99,
725327616047,1-G2C939-12,0,12,12,229.99,
725327616337,1-G2S931,0,0,0,209.99,
725327616290,1-G2S939,15,15,30,219.99,
725327617433,1-G2S939-C,0,0,0,219.99,
725327625766,1-G3B941,0,0,0,249.99,
725327626480,1-G3B941-10,29,13,42,249.99,
725327625810,1-G3B941-15,99,99,198,249.99,
725327629368,1-G3B941-17,99,94,193,249.99,
725327937999,1-G3B941-CK3,0,0,0,299.99,
725327625803,1-G3B941G,26,32,58,249.99,
725327625957,1-G3B941G-15,29,63,92,249.99,
725327625773,1-G3B941T,67,41,108,249.99,
725327625988,1-G3B941T-15,99,75,174,249.99,
725327625704,1-G3B949,99,99,198,259.99,
725327626497,1-G3B949-10,19,18,37,259.99,
725327625759,1-G3B949-15,63,99,162,259.99,
725327619307,1-G3C931,0,15,15,249.99,
725327934479,1-G3C931-10,9,3,12,249.99,
725327625650,1-G3C931-MA,0,0,0,249.99,
725327937609,1-G3C931-SP3,0,0,0,252.99,
725327937616,1-G3C931-SP4,0,0,0,252.99,
725327630968,1-G3C931G-ZEB,0,6,6,274.99,
725327619437,1-G3C939,0,24,24,259.99,
725327630951,1-G3C93C,4,8,12,254.99,
725327623601,1-G3CP931,99,96,195,314.99,
725327631705,1-G3CP931-10,31,6,37,314.99,
725327626343,1-G3CSR9031,23,6,29,249.99,
725327620211,1-G3P941,99,99,198,314.99,
725327936558,1-G3P941-TAC,46,62,108,424.99,
725327934981,1-G3P941-TL1,3,2,5,369.99,
725327626374,1-G3XLSR9041,84,99,183,254.99,
725327626367,1-G3XSR9031,97,21,118,254.99,
725327935391,1-GX4M931,0,0,0,284.99,
725327935827,1-GX4M931-10,49,58,107,284.99,
725327937753,1-GX4M931B,6,24,30,289.99,
725327937739,1-GX4M931G,23,21,44,289.99,
725327936008,1-GX4M93B,25,17,42,294.99,
725327936015,1-GX4M93C,98,47,145,294.99,
725327935988,1-GX4M93E,18,18,36,294.99,
725327935513,1-GX4MP931,99,99,198,309.99,
725327936596,1-GX4MP931-10,6,0,6,309.99,
725327937692,1-GX4MP931-RI,0,0,0,394.99,
725327938101,1-GX4MP931-TL1,69,69,138,369.99,
725327615316,1-TH9041,15,2,17,274.99,
725327615347,1-TH9C031,87,66,153,274.99,
725327939504,1-TX22131,0,26,26,284.99,
725327939511,1-TX22131-10,0,0,0,284.99,
725327939924,1-TX22131-RI,0,1,1,340.0,
725327932017,1-TX22141,0,0,0,254.99,
725327932161,1-TX22141-10,7,1,8,254.99,
725327935018,1-TX22141-10US1,41,99,140,309.99,
725327935001,1-TX22141-US1,31,66,97,309.99,
725327932369,1-TX22141F,28,17,45,254.99,
725327939580,1-TX22231,22,18,40,284.99,
725327932512,1-TX22241,25,8,33,254.99,
725327932741,1-TX22C151,7,10,17,384.99,
725327936664,1-TX22C151-T,14,30,44,429.99,
725327342021,17B6,0,0,0,434.99,
725327341468,17SS6,0,0,0,479.99,
725327627418,2-32721,0,0,0,279.99,
725327627449,2-32729,0,0,0,289.99,
725327617563,2-357051RH,0,0,0,749.99,
725327617594,2-357065RH,0,0,0,759.99,
725327617600,2-357081RH,0,0,0,749.99,
725327617617,2-357085RH,0,0,0,759.99,
725327609377,2-380121UL,0,0,0,404.99,
725327610236,2-380129UL,0,0,0,419.99,
725327605379,2-440029TKRT,0,0,0,539.99,
725327351238,2-440041TKR,0,0,0,469.99,
725327204022,44SS4,0,0,0,529.99,
725327351245,2-440049TKR,0,0,0,479.99,
725327617556,2-440061RH,0,0,0,749.99,
725327204046,M44-6SS,0,0,0,529.99,
725327615583,2-440081RH,0,0,0,749.99,
725327615965,2-440085RH,0,0,0,759.99,
725327610694,2-441021PFS,0,0,0,374.99,
725327608332,2-441029TCPLY,0,0,0,384.99,
725327604532,2-441031MAG,0,0,0,409.99,
725327602118,2-441031T,0,0,0,409.99,
725327607083,2-441031TC,0,0,0,409.99,
725327604525,2-441039MAG,0,0,0,449.99,
725327602125,2-441039T,0,0,0,449.99,
725327607090,2-441039TC,0,0,0,449.99,
725327611189,2-441061MAG,0,0,0,414.99,
725327600954,2-441061T,0,0,0,414.99,
725327611172,2-441069MAG,0,0,0,449.99,
725327600978,2-441069T,0,0,0,449.99,
725327617662,2-454081RH,0,0,0,749.99,
725327617679,2-454085RH,0,0,0,759.99,
725327620617,2-460051RH,0,0,0,779.99,
725327620624,2-460055RH,0,0,0,784.99,
725327620648,2-460061RH,0,0,0,779.99,
725327620631,2-460065RH,0,0,0,784.99,
725327619079,2-460081RH,0,0,0,779.99,
725327619062,2-460085RH,0,0,0,784.99,
725327203018,M605-2B,0,0,0,299.99,
725327609681,2-605021PLY,0,0,0,299.99,
725327203025,M605-2SS,0,16,16,314.99,
725327609698,2-605029PLY,0,0,0,314.99,
725327935056,2-60531NS,0,0,0,349.99,
725327938002,2-60535NS,65,39,104,364.99,
725327935063,2-60535NSVZ,0,0,0,394.99,
725327935049,2-60539NS,0,0,0,349.99,
725327935070,2-6053CNS,0,0,0,379.99,
725327634447,2-605P31,0,0,0,329.99,
725327634430,2-605P39,0,27,27,349.99,
725327320142,M608-4SS,0,0,0,619.99,
725327320166,M608-6SS,0,0,0,619.99,
725327340386,627SS4,0,0,0,429.99,
725327340836,627SS6,0,0,0,429.99,
725327200031,65B4,0,0,0,399.99,
725327330080,65SS4,0,0,0,414.99,
725327200130,66B4,0,0,0,414.99,
725327200154,66SS4,0,0,0,424.99,
725327200161,66B6,0,0,0,414.99,
725327200185,66SS6,0,0,0,424.99,
725327616023,2-692031,0,0,0,524.99,
725327616009,2-692039,0,0,0,569.99,
725327616016,2-692061,0,0,0,524.99,
725327615996,2-692069,0,0,0,569.99,
725327200727,M82-4B,0,0,0,354.99,
725327617488,2-856021CH,10,0,10,284.99,
725327934004,2-856021SW,0,0,0,309.99,
725327617501,2-856021ULCH,0,13,13,284.99,
725327617495,2-856029CH,7,0,7,294.99,
725327934011,2-856029SW,0,0,0,319.99,
725327617518,2-856029ULCH,0,23,23,294.99,
725327620839,2-85621,21,7,28,284.99,
725327620846,2-85629,0,11,11,294.99,
725327620860,2-85629UL,0,0,0,294.99,
725327936763,2-85631E-NSVZ,5,5,10,389.99,
725327933878,2-85631NS,56,36,92,314.99,
725327933892,2-85635NSVZ,24,24,48,364.99,
725327933854,2-85639NS,0,0,0,324.99,
725327933908,2-8563CNS,0,0,0,344.99,
725327935025,2-8563KCCH-NSVZ,12,2,14,399.99,
725327937111,2-856EX39CH,32,17,49,499.99,
725327634461,2-856P31,0,0,0,324.99,
725327634454,2-856P39,2,18,20,334.99,
725327341796,2-905021,0,0,0,309.99,
725327341802,905SS2,0,0,0,319.99,
725327935032,2-90503KCH-SNS,0,0,0,369.99,
725327618287,2-942021,0,0,0,309.99,
725327618560,2-942029,0,0,0,319.99,
725327618713,2-942031,0,0,0,309.99,
725327618720,2-942039,0,0,0,319.99,
725327901150,358-0005-01,0,0,0,27.99,
725327901167,358-0005-02,0,0,0,27.99,
725327901181,358-0007-01,0,8,8,27.99,
725327901204,358-0009-01,0,0,0,27.99,
725327901297,358-0013-01,0,0,0,27.99,
725327901303,358-0014-01,14,10,24,27.99,
725327901389,358-0017-01,0,0,0,19.99,
725327901396,358-0017-02,2,0,2,19.99,
725327901495,358-0021-00,0,12,12,,
725327901501,358-0021-01,0,0,0,,
725327901518,358-0021-02,6,1,7,,
725327935377,358-0025-03,0,0,0,27.99,
725327600251,5-11091-17,0,0,0,27.99,
725327610304,5-11221PLY,13,0,13,19.99,
725327932833,1-1911COM-USGR1,0,0,0,479.99,
725327937760,1-GX4M931-CK1,1,29,30,304.99,
725327931850,2-440085RH-DLX,0,0,0,774.99,
093674826700,CA-AGM-22-1,18,0,18,,
093674826717,CA-AGM-32-1,11,0,11,,
093674826663,CA-AHB-22-1,26,6,32,,
093674826670,CA-AHB-32-1,16,7,23,,
093674826687,CA-ARD-22-1,21,2,23,,
093674826694,CA-ARD-32-1,17,6,23,,
093674824119,CA-BR-22-1,5,10,15,,
093674824102,CA-BR-32-1,7,5,12,,
093674805156,L-BR-23-1,10,7,17,,
093674819672,LA-DTOM-22-1,4,4,8,,
093674825970,LA-HBG-24,1,3,4,,
093674813588,LZ-BTB-52-1,0,7,7,,
093674815001,LZ-DTOM-32-1,26,2,28,,
093674815346,LZ-FL-12-1,7,6,13,,
093674817708,LZ-WUS-32-1,7,6,13,,
093674804784,M-MDG-13-1,1,3,4,,
093674818101,MA-BR-12-1,10,7,17,,
0093674826151,MA-MDG-14,4,2,6,,
093674814462,MZ-AR15-32-1,9,4,13,,
093674813991,MZ-BRF-12-1,3,4,7,,
093674817234,MZ-TK-42-1,12,6,18,,
093674817944,MZ-US-32-1,13,7,20,,
093674824096,N-TKB-32-2,6,3,9,,
093674824058,N-TKG-22-2,5,0,5,,
093674800922,S-CAP-33-1,2,0,2,,
093674823761,SA-AB-32-1,6,7,13,,
093674820159,SA-FL-22-1,6,4,10,,
093674820685,SA-LPD-12-1,11,7,18,,
093674821248,SA-MDT-32-1,6,3,9,,
093674821774,SA-SUN-22-1,20,4,24,,
093674813502,SZ-BR-32-1,16,3,19,,
093674814790,SZ-CATI-62-1,8,1,9,,
093674814950,SZ-DPG-42-1,4,0,4,,
093674826793,XL-AR15-22-1,16,5,21,,
093674826809,XL-AR15-32-1,15,6,21,,
093674826731,XL-BR-22-1,15,3,18,,
093674826748,XL-BR-32-1,7,5,12,,
093674826854,XL-DTOM-22-1,16,6,22,,
093674826861,XL-DTOM-32-1,9,6,15,,
093674826915,XL-FL-22-1,13,6,19,,
093674826922,XL-FL-32-1,13,6,19,,
093674826618,XMC-ABK-12-1,4,14,18,,
093674826625,XMC-ABK-22-1,25,9,34,,
093674826052,AA-AB-22-1,16,7,23,,
093674826069,AA-AB-32-1,9,2,11,,
093674826076,AA-AB-52-1,21,11,32,,
093674826083,AA-AB-62-1,14,7,21,,
093674826175,MA-AG-22-1,79,13,92,,
602686292030,TA5,0,0,0,1239.99,
602686292085,TA5100D,0,0,0,1389.99,
602686211000,T1,0,0,0,1319.99,
602686441001,T1-14,0,0,0,1389.99,
602686422833,T1-14-50DC2,0,0,0,2224.99,
602686422369,T1-14C3,0,0,0,2189.99,
602686213004,T1-C,0,0,0,1259.99,
602686211086,T1100D,0,0,0,1859.99,
602686211031,T150D,0,0,0,1589.99,
602686214032,T150DTG,0,0,0,3229.99,
602686214230,T150DTGTS,0,0,0,4329.99,
602686441100,T1B-14,0,0,0,1789.99,
602686211185,T1B100D,0,0,0,2259.99,
602686211130,T1B50D,0,0,0,1959.99,
602686421935,T1CH,0,0,0,1769.99,
602686212007,T5,0,0,0,1154.99,
602686221009,TM1,0,0,0,1239.99,
602686222006,TM1C,0,0,0,1089.99,
602686422048,TM1C1,0,0,0,1619.99,
602686211222,T13KT,0,0,0,284.99,
602686211123,T14KT,2,1,3,529.99,
602686210126,T11,0,0,0,59.99,
602686210324,T30,0,0,0,189.99,
0064581306438,T32,0,0,0,,
602686218016,T7,0,0,0,184.99,
661120102083,1125572,99,99,198,34.99,
661120102090,1125573,99,99,198,49.99,
661120102106,1125574,99,99,198,69.99,
661120102113,1125575,99,99,198,74.99,
661120102120,1125576,99,99,198,79.99,
661120102137,1125577,99,99,198,,
082442898353,JRT1X300,0,6,6,520.0,
082442898360,JRT1X309,3,0,3,520.0,
082442916705,JRTAC316IT,15,6,21,1849.0,
082442875668,JRTAC316L,0,2,2,1849.0,
082442916699,JRTAC316SBIT,21,15,36,1849.0,
082442875705,JRTAC382L,0,0,0,1849.0,
082442897936,JRTAC482L,0,0,0,1949.0,
082442858937,JRTXA315,0,0,0,780.0,
082442859668,JRTXA315L,0,0,0,810.0,
082442858807,JRTXA316,0,0,0,780.0,
082442859583,JRTXA316L,0,0,0,810.0,
082442858852,JRTXA318,0,0,0,780.0,
082442859576,JRTXA318L,0,0,0,810.0,
082442858869,JRTXA320,0,0,0,780.0,
082442859552,JRTXA320L,0,0,0,810.0,
082442942858,JRTXA331LR10,1,3,4,810.0,
082442942841,JRTXA331R10,0,0,0,780.0,
082442859194,JRTXA351,0,0,0,780.0,
082442859682,JRTXA352L,0,0,0,810.0,
082442859101,JRTXA370,0,0,0,780.0,
082442859828,JRTXA370L,0,0,0,810.0,
082442897844,JRTXA382,0,2,2,780.0,
082442859743,JRTXA716,4,0,4,950.0,
082442859774,JRTXA718,0,0,0,950.0,
082442859729,JRTXA720,0,0,0,950.0,
082442859750,JRTXA751,0,0,0,950.0,
082442859835,JRTXA770,0,0,0,950.0,
082442859545,JRTXB312,0,0,0,720.0,
082442858982,JRTXB315,0,0,0,720.0,
082442858876,JRTXB316,0,0,0,720.0,
082442858814,JRTXB318,0,0,0,720.0,
082442858821,JRTXB320,1,2,3,720.0,
082442942865,JRTXB331R10,5,18,23,720.0,
082442859026,JRTXB340,0,0,0,720.0,
082442858906,JRTXB341,0,0,0,720.0,
082442858975,JRTXB352,2,0,2,720.0,
082442858890,JRTXB370,3,3,6,720.0,
082442884929,JRTXB382,9,0,9,720.0,
082442859415,JRTXB415,3,4,7,770.0,
082442859019,JRTXB416,0,0,0,770.0,
082442859378,JRTXB418,0,0,0,770.0,
082442859248,JRTXB420,1,4,5,770.0,
082442942872,JRTXB431R10,0,0,0,770.0,
082442859514,JRTXB440,0,0,0,770.0,
082442859279,JRTXB441,0,0,0,770.0,
082442859293,JRTXB470,0,0,0,770.0,
082442858883,JRTXC316,0,0,0,930.0,
082442859392,JRTXC316S,0,0,0,1000.0,
082442867793,JRTXC382,0,0,0,930.0,
082442875620,JRTXC382CA,9,7,16,930.0,
082442875644,JRTXC382CAS,0,0,0,1000.0,
082442867809,JRTXC382S,27,4,31,1000.0,
082442859767,JRTXE312,0,3,3,650.0,
082442859217,JRTXE312C,0,1,1,650.0,
082442859361,JRTXE314C,1,3,4,650.0,
082442858838,JRTXE315,0,1,1,650.0,
082442858920,JRTXE315C,1,2,3,650.0,
082442858760,JRTXE316,0,0,0,650.0,
082442858913,JRTXE316C,0,0,0,650.0,
082442858784,JRTXE318,0,0,0,650.0,
082442858777,JRTXE320,3,0,3,650.0,
082442942889,JRTXE331R10,4,14,18,650.0,
082442859163,JRTXE340,0,0,0,650.0,
082442859064,JRTXE341,12,15,27,650.0,
082442858968,JRTXE352,0,0,0,650.0,
082442859071,JRTXE352C,3,4,7,650.0,
082442858944,JRTXE370,2,0,2,650.0,
082442884912,JRTXE382,28,0,28,650.0,
082442859323,JRTXF616,0,0,0,850.0,
082442859255,JRTXF620,0,0,0,850.0,
082442942919,JRTXF631R10,0,0,0,850.0,
082442859439,JRTXF670,0,0,0,850.0,
082442859804,JRTXG315,0,0,0,950.0,
082442859781,JRTXG316,2,2,4,950.0,
082442859620,JRTXG318,0,0,0,950.0,
082442859569,JRTXG320,0,0,0,950.0,
082442859880,JRTXG340,0,0,0,950.0,
082442859873,JRTXG341,0,0,0,950.0,
082442859859,JRTXG370,0,0,0,950.0,
082442859477,JRTXH312,0,0,0,800.0,
082442859538,JRTXH314,0,0,0,800.0,
082442928661,JRTXRT316,3,0,3,920.0,
082442941042,JRTXRT319,0,0,0,920.0,
082442942926,JRTXRT331R10,1,3,4,920.0,
082442928715,JRTXRT370,1,4,5,920.0,
082442928722,JRTXRT382,5,2,7,920.0,
082442924632,JRTXVA316,3,2,5,1170.0,
082442941011,JRTXVA319,0,0,0,1170.0,
082442942902,JRTXVA331R10,15,3,18,1170.0,
082442924649,JRTXVA382,2,0,2,1170.0,
082442924700,JRTXVW316,1,2,3,1170.0,
082442941004,JRTXVW319,0,0,0,1170.0,
082442942896,JRTXVW331R10,1,8,9,1170.0,
082442924717,JRTXVW382,1,1,2,1170.0,
082442811802,S5850372,0,0,0,33.99,
082442811819,S5850373,2,2,4,33.99,
040589018102,SAT73-003,0,0,0,519.99,
040589024196,SAT73-113BTM,0,0,0,619.99,
040589020389,SAT73-122LIB,0,0,0,609.99,
040589029016,SAT73-22251,96,53,149,179.99,
040589027333,CR351130LT,0,0,0,419.99,
040589027661,CR351130WT,0,0,0,419.99,
040589027708,CR451130T,0,0,0,449.99,
040589027685,CR471130T,0,0,0,449.99,
040589029641,CR5-84110440,66,5,71,519.99,
040589029634,CR84110440,40,0,40,449.99,
040589029658,CR841104421,0,0,0,489.99,
040589029672,CR848804425,0,0,0,489.99,
040589120102,A1201,6,0,6,17.29,
040589120300,A1203,4,4,8,6.49,
040589120409,A1204,0,6,6,8.69,
040589027074,A1205B,1,5,6,14.39,
040589030678,A1208FF,0,0,0,6.79,
040589121000,A1210,7,5,12,4.49,
040589121109,A1211,4,6,10,5.79,
040589123806,A1238,6,3,9,5.49,
040589124001,A1240,24,6,30,6.69,
040589125008,A1250,6,6,12,6.49,
040589125701,A1257,2,0,2,12.99,
040589126005,A1260,7,6,13,7.29,
040589127804,A1278,6,6,12,3.99,
040589128405,A1284,6,6,12,2.99,
040589130705,A1307,13,15,28,8.69,
040589130804,A1308,6,6,12,15.79,
040589130903,A1309,6,6,12,24.49,
040589027128,A1314,18,13,31,4.49,
040589131603,A1316,5,3,8,7.29,
040589138008,A1380,2,4,6,11.49,
040589151908,A1519,17,6,23,14.39,
040589152004,A1520,3,6,9,2.99,
040589152202,A1522,5,2,7,3.99,
040589023557,A1577,0,0,0,44.99,
040589005935,A1642,12,12,24,13.79,
040589005959,A1644,24,6,30,15.19,
040589005980,A1647,19,29,48,13.79,
040589172002,A1720,6,0,6,7.29,
040589172101,A1721,0,0,0,19.99,
040589016238,A1738,1,0,1,7.29,
040589008998,A1756,6,0,6,5.49,
040589005249,A1780,0,0,0,6.79,
040589030432,A1785,0,0,0,31.99,
040589011356,A1792,6,6,12,12.19,
040589014074,A1824,18,0,18,13.39,
040589021157,A1880,4,7,11,8.49,
040589026978,A1932,12,6,18,5.49,
040589020471,A1933,6,0,6,6.79,
040589020488,A1934,12,6,18,6.79,
040589020440,A1935,0,0,0,6.79,
040589020457,A1936,24,12,36,6.79,
040589020495,A1937,12,6,18,6.79,
040589020501,A1939,0,0,0,6.79,
040589022765,A1940,0,0,0,7.99,
040589030456,A1945,0,0,0,8.29,
040589030463,A1946,0,0,0,6.89,
040589027845,A1950,10,6,16,12.99,
040589024936,A2000,26,12,38,20.79,
040589024943,A2001,12,19,31,14.89,
040589024967,A2003,6,3,9,14.89,
040589024981,A2005,24,21,45,14.89,
040589025001,A2007,33,9,42,17.79,
040589025049,A2011,77,18,95,17.79,
040589029962,A2013,24,6,30,16.69,
040589315003,A3150,4,2,6,41.59,
040589370002,A3700,6,0,6,41.59,
040589030401,A3702,0,0,0,34.99,
040589021140,A3801,2,6,8,12.69,
040589023748,A3857,6,0,6,11.49,
040589030418,A3964,0,0,0,26.69,
040589002125,A791DS,27,12,39,6.79,
040589002149,A793DS,88,12,100,6.79,
040589002163,A798DS,18,27,45,7.99,
040589994505,ASA45,9,6,15,14.79,
040589992204,ASC22,0,7,7,5.49,
040589992235,ASC223,15,18,33,7.99,
040589993089,ASC308,4,7,11,7.99,
040589993898,ASC38,0,9,9,12.29,
040589993805,ASC380,15,10,25,14.79,
040589994000,ASC40,0,6,6,14.79,
040589994512,ASC45,4,3,7,13.49,
040589994574,ASC4570,6,6,12,7.99,
040589029627,ASC65C,12,9,21,7.99,
040589991207,ASG12,11,16,27,6.79,
040589992006,ASG20,12,6,18,6.79,
040589999005,ASM9,87,33,120,14.79,
040589185118,FR18511,0,0,0,239.99,
040589002958,FR1851136,0,0,0,239.99,
040589185125,FR18512,0,0,0,264.99,
040589185811,FR18581,0,4,4,269.99,
040589185828,FR18582,0,0,0,334.99,
040589186016,FR18601,10,0,10,274.99,
040589002996,FRS18511,3,0,3,289.99,
040589003016,FRS18581,13,17,30,324.99,
040589018867,KPC50602,2,0,2,209.99,
040589018874,KPC51002,0,0,0,294.99,
040589106007,P1060,0,0,0,229.99,
040589109008,P1090,0,0,0,339.99,
040589012612,KR52628100,0,0,0,419.99,
040589018881,KRC52206,0,0,0,309.99,
040589018898,KRC52408,0,0,0,369.99,
040589201009,R2010,0,0,0,449.99,
040589202006,R2020,0,0,0,389.99,
040589000282,R26128101,0,0,0,469.99,
040589027388,R381401,43,0,43,529.99,
040589028484,R382050,20,0,20,389.99,
040589028491,R3820516,0,0,0,459.99,
040589030012,R3880525,0,0,0,459.99,
040589030050,R391050,0,0,0,364.99,
040589030036,R392001,0,0,0,434.99,
040589030043,R3980525,0,0,0,419.99,
040589028231,R5-56110460,0,0,0,419.99,
040589030029,R5-568804625,0,0,0,499.99,
040589028330,R5-72000840,0,0,0,279.99,
040589030340,R5-721108432,0,0,0,349.99,
040589028286,R5-74110440,0,0,0,374.99,
040589030692,R5-748804433,57,10,67,419.99,
040589029726,R56115060,7,0,7,349.99,
040589029733,R561150621,5,0,5,419.99,
040589028194,R59110460,1,0,1,359.99,
040589028309,R72000840,9,0,9,194.99,
040589029092,R72000840S,5,0,5,209.99,
040589028392,R72110840WA,0,0,0,254.99,
040589030326,R721108432,0,0,0,274.99,
040589028255,R74110440S,18,0,18,309.99,
040589029740,R74115040,0,0,0,299.99,
040589028248,R748804425,0,0,0,344.99,
040589028576,RC5-72000840,0,0,0,299.99,
040589019826,RS3200850,9,0,9,339.99,
040589028521,RS72000840,13,0,13,244.99,
040589026039,SAT73-22053,0,0,0,189.99,
040589026022,SAT73-22250,72,78,150,179.99,129.99
040589123707,A1237,3,0,3,7.99,6.49
040589133003,A1330,1,0,1,4.49,2.99
040589030708,CR5-848804433,6,3,9,549.99,
040589030715,CRS-358833L,0,0,0,549.99,
864845000317,LS-BLK,11,6,17,29.99,
864845000324,LS-DB,59,32,91,29.99,
864845000300,LC1,66,22,88,269.99,
850006047369,LC1-MT,11,8,19,279.99,
850006047215,LC1-P,19,11,30,234.99,
850006047239,LC1-P-T,5,5,10,249.99,
850006047413,LC1-SG,17,31,48,279.99,
850006047628,LC1-T,5,4,9,289.99,
864845000386,LC2,22,10,32,269.99,
850006047116,LC2-SG,15,19,34,279.99,
850006047475,P9-BLK,25,15,40,1434.99,1379.99
719307215207,GL801-C-601102,6,4,10,104.99,
719307215245,GL813-C-601106,6,4,10,104.99,
719307200241,GL01,0,1,1,84.99,
719307209633,GL101O,0,4,4,114.99,
719307209640,GL101Y,47,0,47,114.99,
719307212695,GL113-C-600784,0,0,0,114.99,
719307212701,GL113-C-600785,58,70,128,114.99,
719307212626,GL13-C-600777,48,0,48,84.99,
719307211162,GL201-C-600649,0,0,0,99.99,
719307211285,600661,0,0,0,99.99,
719307213876,GL601-C-600836,19,0,19,119.99,
719307300095,TA31F,6,3,9,1039.99,
719307400450,200028,0,0,0,679.99,
719307613003,AC32064,0,4,4,13.49,
719307615946,AC32085,12,2,14,12.49,
719307616455,AC32092,0,0,0,46.49,
719307616462,AC32096,4,0,4,46.49,
719307616318,AC32098,0,0,0,69.49,
719307616332,AC32099,10,26,36,46.49,43.49
719307402973,2800002,1,0,1,459.99,
719307402966,2800001,3,2,5,424.99,
719307616370,CC06-C-3100001,0,3,3,459.99,
719307616387,CC07-C-3100002,4,3,7,459.99,
719307402980,2900011,1,1,2,684.99,
719307403024,2900015,3,2,5,819.99,
719307403062,2900032,2,2,4,1229.99,
719307403147,2900040,3,2,5,549.99,
719307403369,2900033,2,0,2,889.99,
719307402959,2700003,3,2,5,459.99,
719307402904,2700001,2,1,3,424.99,
719307616165,2600001,15,6,21,359.99,
719307630161,2200003,6,4,10,389.99,
719307630185,2200005,6,3,9,429.99,
719307630192,2200006,6,4,10,429.99,
719307616028,2200052,8,9,17,659.99,
719307616035,2200053,6,5,11,659.99,
719307616073,2200057,8,7,15,964.99,
719307609181,RM05G,1,4,5,394.99,
719307614239,RM06-C-700672,0,0,0,479.99,
719307614475,RM06-C-700696,1,0,1,514.99,
719307615922,RM06-C-700780,1,0,1,504.99,
719307614307,RM07-C-700679,0,3,3,479.99,
719307615779,2500001,14,14,28,504.99,
719307615786,2500002,0,0,0,504.99,
719307615793,2500003,0,0,0,504.99,
719307311855,TA11-D-100557,20,4,24,1674.99,1449.99
719307302754,100163,2,1,3,1114.99,
719307302945,100218,1,2,3,1039.99,
719307303027,100224,3,2,5,1039.99,
719307302068,100226,3,2,5,1194.99,
719307302075,100230,3,2,5,1194.99,
719307313880,400329,3,2,5,889.99,
719307313897,400330,3,2,5,889.99,
719307617193,400389,3,2,5,889.99,
719307617209,400390,3,2,5,889.99,
719307313934,400341,3,0,3,934.99,
719307313958,400343,3,2,5,934.99,
719307400207,200004,3,2,5,614.99,
719307400429,200005,4,3,7,614.99,
719307400511,200024,0,0,0,679.99,
719307400535,200043,3,2,5,954.99,
719307400290,200061,3,2,5,749.99,
719307401655,200089,3,2,5,954.99,
719307617247,2400012,0,0,0,2164.99,
719307617131,2400013,0,0,0,2024.99,
719307215221,GL804-C-601104,35,0,35,104.99,
719307215436,AC50015,15,0,15,49.99,
719307616288,AC32093,22,15,37,69.99,
719307616301,AC32094,29,16,45,69.99,
719307616295,AC32095,4,7,11,69.99,
719307616325,AC32097,25,11,36,69.99,
713780987675,98767,16,11,27,879.99,
713780201207,20120,0,0,0,374.99,
713780201283,20128,0,5,5,359.99,
713780201382,20138,0,0,0,424.99,
713780202020,20202,0,0,0,424.99,
713780202037,20203-TRI,0,0,0,394.99,
713780202044,20204,0,0,0,359.99,
713780202068,20206,0,0,0,359.99,
713780202082,20208,0,0,0,424.99,
713780231297,23129,2,5,7,314.99,
713780231334,23133,0,0,0,314.99,
713780231372,23137,0,0,0,314.99,
713780231396,23139,0,0,0,339.99,
713780231433,23143,10,6,16,339.99,
713780231464,23146,3,7,10,274.99,
713780231488,23148,4,1,5,324.99,
713780231501,23150,6,4,10,354.99,324.99
713780231525,23152,5,2,7,274.99,
713780231549,23154,2,0,2,324.99,
713780231563,23156,0,0,0,274.99,
713780231587,23158,0,0,0,324.99,
713780231600,23160,0,0,0,254.99,
713780231624,23162,0,0,0,289.99,
713780231648,23164,0,0,0,269.99,
713780241005,24100,0,1,1,559.99,
713780241012,24101,9,3,12,559.99,
713780241029,24102,2,5,7,559.99,
713780241036,24103,4,2,6,559.99,
713780241043,24104,3,2,5,584.99,
713780241050,24105,2,9,11,514.99,
713780241067,24106,5,9,14,514.99,
713780241074,24107,5,4,9,514.99,
713780241081,24108,2,1,3,514.99,
713780241128,24112,0,2,2,529.99,
713780241135,24113,5,2,7,559.99,
713780241142,24114,8,4,12,599.99,
713780241173,24117,4,3,7,609.99,
713780241180,24118,13,4,17,609.99,
713780241197,24119,3,1,4,609.99,
713780241296,24129,0,0,0,599.99,
713780241302,24130,3,0,3,559.99,
713780241326,24132,7,1,8,559.99,
713780241333,24133,8,5,13,629.99,
713780241340,24134,6,3,9,584.99,
713780241357,24135,10,0,10,584.99,
713780241395,24139,5,2,7,584.99,
713780241432,24143,3,0,3,619.99,
713780241517,24151,10,3,13,609.99,
713780241524,24152,2,0,2,609.99,
713780241531,24153,7,10,17,654.99,
713780241593,24159,4,4,8,529.99,
713780241616,24161,9,7,16,529.99,
713780241654,24165,0,0,0,549.99,
713780241821,24182,3,0,3,584.99,
713780241890,24189,5,1,6,679.99,
713780241920,24192,2,0,2,659.99,
713780241937,24193,3,0,3,659.99,
713780241951,24195,1,0,1,584.99,
713780241968,24196,2,0,2,584.99,
713780241982,24198,0,0,0,599.99,
713780242262,24226-TRI,5,0,5,629.99,
713780242279,24227,5,0,5,629.99,
713780242309,24230,2,0,2,629.99,
713780242507,24250,1,2,3,624.99,
713780242545,24254,0,0,0,624.99,
713780242583,24258-TRI,0,1,1,774.99,
713780242606,24260-TRI,0,0,0,649.99,
713780242613,24261,1,2,3,649.99,
713780242620,24262,0,0,0,669.99,
713780242637,24263-TRI,1,4,5,669.99,
713780242651,24265-TRI,0,0,0,739.99,
713780242668,24266,0,1,1,784.99,
713780242675,24267,0,0,0,739.99,
713780242682,24268,0,0,0,784.99,
713780242699,24269,3,3,6,784.99,
713780301297,30129,0,0,0,489.99,
713780302065,30206-TRI,0,0,0,489.99,
713780302881,30288,0,0,0,514.99,
713780304182,30418,0,0,0,514.99,
713780331027,33102,6,1,7,644.99,
713780331041,33104,3,0,3,644.99,
713780331065,33106,2,2,4,644.99,
713780331089,33108,2,3,5,644.99,
713780331102,33110,5,0,5,644.99,
713780331126,33112,3,4,7,644.99,
713780331140,33114-TRI,4,2,6,644.99,
713780331164,33116,8,2,10,654.99,
713780331188,33118,5,5,10,654.99,
713780352206,35220,3,0,3,664.99,
713780352220,35222,7,2,9,664.99,
713780352244,35224,3,2,5,664.99,
713780352268,35226,2,1,3,689.99,
713780352282,35228,2,0,2,689.99,
713780354118,35411,3,0,3,1049.99,
713780354125,35412,3,2,5,1199.99,
713780354149,35414,4,5,9,1289.99,
713780354163,35416,8,5,13,1349.99,
713780354187,35418,0,0,0,1699.99,
713780354200,35420,3,6,9,1999.99,
713780354255,35425,0,3,3,879.99,
713780354309,35430,3,5,8,769.99,
713780354330,35433,6,0,6,769.99,
713780354361,35436,0,0,0,789.99,
713780354392,35439,5,4,9,789.99,
713780380124,38012,10,15,25,899.99,
713780380209,38020,5,3,8,899.99,
713780380285,38028,4,4,8,939.99,
713780380414,38041,2,3,5,939.99,
713780381121,38112,6,4,10,859.99,
713780381206,38120,5,1,6,859.99,
713780381282,38128,1,3,4,889.99,
713780381411,38141,7,5,12,889.99,
713780985275,98527,0,0,0,649.99,
713780987385,98738,29,17,46,739.99,689.99
713780987392,98739,14,9,23,819.99,
713780987408,98740,22,19,41,799.99,
713780987507,98750,0,0,0,489.99,
713780987514,98751,0,0,0,489.99,
713780987538,98753,0,0,0,449.99,
713780987545,98754,0,0,0,449.99,
713780987569,98756,0,0,0,509.99,
713780987576,98757,0,0,0,509.99,
713780987651,98765,14,12,26,879.99,
713780987682,98768,10,7,17,899.99,
713780987699,98769,15,10,25,899.99,
713780251226,25122,30,0,30,614.99,
713780251257,25125,11,0,11,439.99,
713780301280,30128-TRI,0,0,0,379.99,
811069022120,TS-12X-SFP,1,0,1,,
811069021550,TS-8X-RBR,0,0,0,469.99,
811069021642,TS-8X-SFP,2,0,2,409.99,
811069022205,TSR-1X-QD,25,43,68,209.99,
723364111327,2211132,3,15,18,14.99,
723364300363,2230036,5,5,10,8.29,
723364526619,2252661,22,6,28,33.99,
723364540523,2254052,57,7,64,7.99,
723364513251,2251325,4,0,4,10.99,
723364513268,2251326,0,3,3,10.99,
723364513848,2251384,20,12,32,2.99,
723364518140,2251814,0,0,0,33.99,
723364518232,2251823,6,6,12,37.99,
723364523014,2252301,2,0,2,22.99,
723364523090,2252309,5,0,5,23.99,
723364530197,2253019,0,0,0,38.99,
723364540462,2254046,6,0,6,,
723364550058,2255005,6,0,6,24.99,
723364552014,2255201,7,6,13,7.0,
723364552090,2255209,6,6,12,25.99,
723364552137,2255213,4,2,6,,
723364112843,2211284,17,99,116,22.99,
723364526633,2252663,15,11,26,21.99,20.59
723364442452,2244245,33,43,76,37.99,
723364523007,2252300,54,0,54,42.99,
723364523045,2252304,12,13,25,37.99,
723364523069,2252306,98,14,112,88.99,
723364523083,2252308,8,18,26,62.99,
723364524165,2252416,60,36,96,90.99,
723364530043,2253004,13,2,15,73.99,
723364530173,2253017,9,2,11,109.99,
723364530241,2253024,0,26,26,111.99,
723364540202,2254020,5,11,16,46.99,
723364540455,2254045,3,0,3,59.99,
723364540516,2254051,5,4,9,101.99,
723364548062,2254806,31,23,54,105.99,
723364550041,2255004,4,12,16,72.99,
723364550508,2255050,4,29,33,31.99,
723364550515,2255051,3,2,5,30.99,
723364552007,2255200,0,0,0,53.99,
723364552083,2255208,1,0,1,74.99,
723364552120,2255212,6,15,21,75.99,
723364552144,2255214,0,0,0,99.99,
723364560101,2256010,0,3,3,50.99,
723364921124,2292112,11,0,11,65.99,
723364440014,2244001,11,60,71,124.99,
723364440205,2244020,0,6,6,68.99,
723364442414,2244241,16,1,17,159.99,
723364513183,2251318,0,10,10,103.99,
723364513237,2251323,1,2,3,136.99,
723364513244,2251324,25,0,25,136.99,124.99
723364513657,2251365,0,0,0,108.99,
723364513787,2251378,2,3,5,269.99,
723364513831,2251383,20,17,37,36.99,
723364513893,2251389,3,4,7,232.99,
723364518133,2251813,7,3,10,156.99,
723364518171,2251817,6,6,12,140.99,
723364518201,2251820,4,6,10,182.99,
723364518225,2251822,27,13,40,152.99,
723364521577,2252157,8,9,17,374.99,
723364523106,2252310,20,6,26,115.99,
723364523120,2252312,51,47,98,105.99,
723364526350,2252635,1,3,4,700.99,
723364526602,2252660,0,32,32,299.99,249.99
723364526626,2252662,11,23,34,128.99,
723364526688,2252668,21,33,54,235.99,214.99
723364548253,2254825,0,19,19,315.99,
723364548284,2254828,1,2,3,318.99,
723364548291,2254829,0,0,0,366.99,
723364548352,2254835,0,0,0,482.99,
723364801938,2280193-6,1,59,60,623.94,439.99
723364802034,2280203,60,51,111,91.99,79.99
723364921308,2292130,15,15,30,102.99,
723364524127,2252412,12,15,27,56.99,
723364442339,2244233,54,23,77,108.99,74.99
723364526046,2252604,1,1,2,259.99,
723364526053,2252605,3,0,3,258.99,
723364524134,2252413,0,1,1,11.99,
811069028962,223WYBR0004,0,0,0,459.99,
811069028955,223WYBR0005,4,0,4,449.99,
811069028511,223WYBR0006-FDE,99,85,184,519.99,449.99
811069028535,223WYFS0000,0,0,0,479.0,
811069028542,223WYFS0001,0,0,0,489.0,
811069028702,223WYFS0001-ODG,0,0,0,549.0,
811069028580,223WYFS0001-STG,0,0,0,549.0,
811069028665,223WYFS0001-VRB,0,0,0,549.0,
811069028566,223WYFS0003,0,0,0,589.0,
661120260202,1135994,59,32,91,,
661120260219,1135995,90,7,97,,
661120260233,1135997,34,14,48,,
661120260240,1135998,46,42,88,,
661120260257,1135999,53,15,68,,
661120260295,1136003,50,20,70,,
661120260301,1136004,59,5,64,,
661120260318,1136005,28,14,42,,
661120075882,1100086,50,42,92,,
661120075943,1100092,88,27,115,,
661120078944,1116434,14,25,39,,
661120078968,1116438,84,13,97,,
044356014038,LB7,34,0,34,,
661120653448,1183266,0,6,6,,
661120653530,1183287,7,0,7,,
661120653578,1183292,55,12,67,,
661120747840,1200439,0,0,0,,
661120747871,1200442,0,0,0,,
661120747888,1200443,0,0,0,,
661120747918,1200446,0,0,0,,
661120747932,1200448,0,0,0,,
663306125527,P12552,24,0,24,19.99,18.25
663306140483,P14048,40,13,53,24.99,
663306200354,P20035,16,2,18,25.99,24.25
663306200408,P20040,57,8,65,27.99,
663306200453,P20045,10,30,40,30.99,
663306203058,P20305,16,7,23,29.99,
663306210094,P21009,57,37,94,5.29,
663306210117,P21011,45,39,84,5.29,
663306210131,P21013,81,75,156,5.29,
663306211022,P21102,19,9,28,22.99,
663306211039,P21103,6,5,11,22.99,
663306211046,P21104,10,7,17,22.99,
663306211053,P21105,30,9,39,22.99,
663306211060,P21106,10,0,10,22.99,
663306211077,P21107,30,16,46,11.99,
663306211084,P21108,39,3,42,11.99,
663306211220,P21122,15,8,23,11.99,
663306211237,P21123,19,2,21,11.99,
663306211244,P21124,13,6,19,,
663306212111,P21211,36,19,55,,
663306214115,P21411,0,0,0,,
663306217116,P21711,54,24,78,,
663306217130,P21713,95,85,180,5.29,
663306223209,P22320,15,7,22,54.99,47.5
663306232058,P23205,31,15,46,20.99,19.0
663306261072,P26107,30,15,45,,
663306261089,P26108,30,20,50,15.99,
663306262079,P26207,30,17,47,17.99,
663306262086,P26208,30,20,50,15.99,
663306263076,P26307,30,20,50,10.99,
663306263083,P26308,30,20,50,10.99,
663306300245,P30024,28,8,36,26.99,
663306300283,P30028,21,11,32,37.99,
663306300320,P30032,16,13,29,36.99,
663306300368,P30036,12,18,30,59.99,
663306300429,P30042,21,18,39,64.99,
663306515151,P51515,4,4,8,19.99,
810162018566,VC3SN-0456,4,4,8,1589.99,
840300700534,VC3SN-0540,1,8,9,1169.99,
840300700541,VC3SN-0541,3,8,11,1169.99,
810162016517,VC45SN-6-HBW,0,0,0,1529.99,
810162017361,VC45SN-B6-HG-TS,3,6,9,1174.99,
810162019426,VC4LLV-0025,0,0,0,379.99,
810162014520,VC4LLV-6-C-B-TS,20,0,20,419.99,
810162018504,VF4H-0001,9,0,9,1319.99,
810162018511,VF4H-0002,0,4,4,1319.99,
840300700466,VF4H-0097,0,0,0,1554.99,
810162018221,VF4M-0017,2,5,7,1569.99,
810162018214,VF4M-0018,11,11,22,1569.99,
810162018368,VF4M-0026,0,2,2,1264.99,
810162018290,VF4M-0027,0,5,5,1264.99,
810162018306,VF4M-0031,4,3,7,1349.99,
810162018399,VF4M-0048,8,3,11,1569.99,
810162018405,VF4M-0049,8,1,9,1569.99,
810162019389,VF4M-0063,10,1,11,1424.99,
810162019372,VF4M-0064,10,5,15,1424.99,
810162018573,VF4M0098,0,0,0,1239.99,
810162019631,VF4M-6X,9,3,12,1179.99,
810162019396,VF4M-X,13,6,19,1179.99,
810162017330,VCB-LR-B,0,0,0,1059.99,
810162017620,VCB-M2-B,0,0,0,1059.99,
810162017637,VCB-M2-FDE,0,0,0,1059.99,
810162015664,VCF-LR-BG,0,0,0,1549.99,
810162018931,VCR-0131,2,3,5,1419.99,
810162018924,VCR-0132,0,0,0,1419.99,
810162019068,VCR-0159,0,0,0,1649.99,
840300700794,VCS-0405,0,0,0,1984.99,
840300700800,VCS-0406,0,0,0,1984.99,
810162019525,VF-ORYX,0,0,0,1804.99,
810162019969,VFVT2-B,0,0,0,2279.99,
810162019952,VFVT2-HMR,1,1,2,1914.99,
840300700039,VFVT2-LR,0,0,0,1794.99,
810162019945,VFVT2-WMR,4,6,10,1914.99,
810162013752,VC2BT-G,0,4,4,239.99,
810162014407,VC4AK,4,0,4,109.99,
810162017293,VC4AK-ST,0,5,5,124.99,
810162015183,VC4BT-B,10,1,11,239.99,
810162010904,VCTP-1-B-10,6,3,9,209.99,
810162017798,VCTP-1-FDE-10,3,1,4,209.99,
810162013615,VCTP-1-OD-10,2,1,3,209.99,
810162010911,VCTP-1-S-10,2,0,2,209.99,
723364209369,2805961,4,9,13,359.0,
723364209352,2807076,72,0,72,599.0,
723364213526,2807076TNS,0,0,0,695.0,
723364210525,2807696,0,0,0,409.0,
723364216954,2842475,12,16,28,540.0,
723364216152,2842521,5,0,5,670.0,
723364220784,2842734,33,14,47,540.0,
723364216176,2844176,0,0,0,670.0,
723364216985,2844222,76,46,122,540.0,
723364215940,2846926,10,5,15,799.0,
723364215926,2846942,4,4,8,1459.0,
723364215933,2846951,13,2,15,1569.0,
723364220791,2849313,27,18,45,540.0,
723364216961,2851229,13,11,24,540.0,
723364218262,2851237,13,14,27,540.0,
723364227080,2858363,4,12,16,540.0,
723364227097,2858371,3,10,13,540.0,
723364227103,2858380,0,11,11,540.0,
723364227110,2858398,7,0,7,540.0,
723364227127,2858401,12,7,19,540.0,
723364227134,2858410,21,4,25,540.0,
723364227059,2858428,0,0,0,540.0,
723364227073,2858436,9,4,13,540.0,
723364227066,2858444,8,10,18,540.0,
723364229961,2874172,0,0,0,659.0,
723364228926,2876574,69,93,162,670.0,
723364229695,2876582,99,84,183,670.0,
723364229992,2877490,0,0,0,670.0,
723364230004,2877503,0,0,0,670.0,
723364230011,2877511,0,0,0,670.0,
723364230028,2877520,0,0,0,670.0,
723364209932,4796001,14,79,93,729.0,
723364209949,4796002,15,9,24,729.0,
723364209956,4796004,0,0,0,729.0,
723364214462,4796004WG,97,99,196,759.0,
723364209963,4796006,0,0,0,729.0,
723364200250,5030300,2,25,27,319.0,
723364200267,5030320,45,99,144,319.0,
723364212734,5082500,99,63,162,389.0,
723364212741,5082501,80,12,92,389.0,
723364215308,5082512,0,0,0,389.0,
723364220722,5083500,20,10,30,389.0,
723364220739,5083501,0,0,0,389.0,
723364220760,5083505,25,10,35,389.0,
723364220746,5083512,0,0,0,389.0,
723364205323,5100300,34,0,34,329.0,
723364206993,5100301,48,7,55,369.0,
723364207006,5100302,99,99,198,415.0,
723364200335,5120333,0,9,9,279.0,
723364200359,5120334,0,42,42,349.0,
723364200342,5120336,0,11,11,279.0,
723364200366,5120337,0,0,0,349.0,
723364200373,5120338,0,52,52,279.0,
723364211140,5120362,0,0,0,279.0,
723364212963,5120363,0,0,0,279.0,
723364215360,5120365,0,14,14,279.0,
723364214547,5120700,64,17,81,279.0,
723364214554,5120715,0,0,0,279.0,
723364214561,5120725,0,46,46,279.0,
723364214585,5120729,51,16,67,315.0,
723364214592,5120753,32,20,52,315.0,
723364214608,5120760,0,0,0,279.0,
723364215452,5120765,99,16,115,279.0,
723364200854,5170304,30,19,49,339.0,
723364200878,5170308,88,53,141,349.0,
723364200885,5170310,0,0,0,359.0,
723364224591,5220300,99,99,198,419.0,
723364224652,5220302,21,12,33,419.0,
723364212994,5760500,24,20,44,375.0,
723364214257,576050010,67,38,105,375.0,
723364227226,5760500AX,7,1,8,364.99,
723364229763,5760502AX,99,99,198,379.99,
723364203275,2246010,0,0,0,32.5,
723364203299,2246012,0,0,0,32.5,
723364200403,2796422,49,38,87,32.5,
723364200410,2796449,60,81,141,35.0,
723364200465,2796678,12,0,12,32.5,
723364200472,2796694,6,12,18,35.0,
723364200502,2796708,0,0,0,35.0,
723364210471,2807793,0,5,5,32.5,
723364210488,2807807,18,13,31,32.5,
723364210303,2810883,12,17,29,32.5,
723364220333,2856891,0,0,0,35.0,
723364220340,2856905,0,2,2,32.5,
723364200717,503600,0,0,0,30.0,
723364200700,505600,0,8,8,30.0,
723364207402,50860002,8,30,38,30.0,
723364210563,50862002,46,38,84,30.0,
723364207211,51060002,85,30,115,32.5,
723364207228,51060102,0,0,0,32.5,
723364200724,512602,0,0,0,30.0,
723364200731,512604,0,0,0,30.0,
723364200892,517602,13,13,26,30.0,
723364200908,517604,0,3,3,30.0,
723364213663,576610,21,23,44,30.0,
723364213670,576620,0,0,0,30.0,
723364213687,576630,0,0,0,,
723364210570,281329710,1,12,13,199.0,
723364215964,2846934,0,0,0,637.0,
723364215957,2846977,43,9,52,799.0,
747115449491,EBO1222PGM,0,42,42,629.99,529.99
747115449408,EBO1226PGM,0,5,5,629.99,519.99
747115449507,EBO2022PGM,0,34,34,629.99,529.99
747115449415,EBO2026PGM,10,42,52,629.99,519.99
747115425242,ESN1226PGM,3,0,3,514.99,
747115425235,ESN1228PGM,6,0,6,514.99,
747115425266,ESN2026PGM,0,0,0,514.99,
747115425259,ESN2028PGM,0,0,0,514.99,
747115444540,EST1226PGM,15,21,36,589.99,
747115443727,EST1228PGM,2,1,3,589.99,
747115443734,EST2026PGM,8,6,14,589.99,
747115436927,EUP1226PGM,0,0,0,629.99,
747115436934,EUP1228PGM,3,1,4,629.99,
747115436941,EUP2026PGM,13,12,25,629.99,
747115436958,EUP2028PGM,6,3,9,629.99,
747115425280,EWF1226PGM,2,0,2,629.99,
747115425273,EWF1228PGM,0,0,0,629.99,
747115429622,EWF2026PGM,6,16,22,629.99,
747115425297,EWF2028PGM,17,15,32,629.99,
747115436606,ID21228MAG,2,1,3,1534.99,
747115450312,IFC1228MAG,1,2,3,1059.99,
747115436729,IWM1228SMG,1,1,2,1059.99,
747115439263,IWMBL1228SMG,0,1,1,1059.99,
747115436712,IWR1228SMG,0,1,1,1059.99,
747115439270,IWRT1228SMG,0,1,1,1059.99,
747115440160,MAM01N257WR8B,0,0,0,1824.99,
747115440191,MAM01N300NR8B,0,1,1,1824.99,
747115440207,MAM01N300WR8B,1,0,1,1824.99,
747115440214,MAM01N303WR8B,1,1,2,2074.99,
747115450367,MAM01N338WR6B,0,0,0,1824.99,
747115440153,MAM01N653WR8B,0,0,0,1824.99,
747115440146,MAM01N65RWR6B,0,2,2,1824.99,
747115446230,MAM05N300WR8B,0,0,0,2189.99,
747115446247,MAM05N653WR8B,0,0,0,2189.99,
747115446254,MAM05N65CMR6B,1,0,1,2189.99,
747115446261,MAM05N65RWR6B,1,1,2,2189.99,
747115450923,MAX01N257WR8B,1,0,1,2399.99,
747115450930,MAX01N270WR8B,1,0,1,2399.99,
747115450947,MAX01N300NR8B,0,0,0,2399.99,
747115450954,MAX01N300WR8B,0,0,0,2399.99,
747115450985,MAX01N303WR8B,0,0,0,2399.99,
747115450961,MAX01N308NR4B,0,0,0,2399.99,
747115450992,MAX01N333WR8B,0,0,0,2399.99,
747115450978,MAX01N338WR6B,0,0,0,2399.99,
747115451029,MAX01N653WR8B,0,0,0,2399.99,
747115451005,MAX01N65CMR6B,0,0,0,2399.99,
747115451012,MAX01N65RWR6B,0,0,0,2399.99,
747115448425,MBC20N257WR8B,1,0,1,2314.99,
747115448449,MBC20N280AR6B,1,0,1,2314.99,
747115448456,MBC20N300WR8B,0,0,0,2314.99,
747115448487,MBC20N653WR8B,1,0,1,2314.99,
747115448500,MBC20N65CMR4B,2,2,4,2314.99,
747115448517,MBC20N65RWR6B,0,2,2,2314.99,
747115448586,MBT20N257WR8B,0,0,0,3014.99,
747115448609,MBT20N280AR6B,0,0,0,3014.99,
747115448616,MBT20N300WR8B,0,0,0,3014.99,
747115448647,MBT20N653WR8B,0,0,0,3014.99,
747115448661,MBT20N65CMR4B,0,0,0,3014.99,
747115448678,MBT20N65RWR6B,0,0,0,3014.99,
747115448746,MCB20N257WR8B,1,0,1,2919.99,
747115448777,MCB20N300WR8B,0,0,0,2919.99,
747115448845,MCB20N303WR8B,0,0,0,2919.99,
747115448807,MCB20N653WR8B,0,0,0,2919.99,
747115448821,MCB20N65CMR4B,0,0,0,2919.99,
747115448838,MCB20N65RWR6B,0,0,0,2919.99,
747115441914,MCM01N300WR8B,0,0,0,2314.99,
747115441884,MCM01N65RWR6B,1,0,1,2314.99,
747115448920,MCT20N257WR8B,0,0,0,3409.99,
747115448951,MCT20N300WR8B,0,0,0,3409.99,
747115448982,MCT20N653WR8B,0,0,0,3409.99,
747115449002,MCT20N65CMR4B,0,0,0,3409.99,
747115449019,MCT20N65RWR6B,0,0,0,3409.99,
747115449385,MCU03N280AR6B,0,0,0,1764.99,
747115449392,MCU03N65CMR4B,1,0,1,1764.99,
747115440900,MDX01N257WR6O,0,0,0,2199.99,
747115440948,MDX01N300WR6O,0,0,0,2199.99,
747115440924,MDX01N653WR6O,0,0,0,2199.99,
747115425471,OR11226RGG,14,16,30,814.99,
747115425488,OR11228RGG,42,47,89,814.99,
747115425501,OR12028RGG,0,0,0,814.99,
747115444502,OR1MB1226RGG,2,2,4,814.99,
747115444489,OR1MB1228RGG,0,5,5,814.99,
747115433490,OSP1230PGG,0,0,0,949.99,
747115419098,SA08SY2024PGM,10,8,18,589.99,
747115436446,VAP257WR6O,2,0,2,699.99,
747115436460,VAP300NR6O,0,0,0,699.99,
747115436514,VAP653WR6O,0,0,0,699.99,
747115436521,VAP65CMR4O,2,0,2,699.99,
747115445561,VAP65PPR4O,1,0,1,699.99,
747115421022,VDT222RR4O,0,0,0,759.99,
747115421039,VDT223RR4O,0,0,0,759.99,
747115421046,VDT243NR4O,0,0,0,759.99,
747115421558,VDT256RR4O,0,0,0,759.99,
747115431250,VDT257WR6O,0,0,0,759.99,
747115421107,VDT270NR4O,0,0,0,759.99,
747115431267,VDT300NR6O,4,9,13,759.99,
747115431274,VDT300WR6O,8,4,12,759.99,
747115421053,VDT308NR4O,0,0,0,759.99,
747115446711,VDT653WR6O,0,0,0,759.99,
747115438426,VDT65CMR4O,2,4,6,759.99,
747115421060,VDT7M8RR4O,0,0,0,759.99,
747115431281,VDT7MMRR6O,8,5,13,759.99,
747115451326,VFP256RR6B,0,0,0,899.99,
747115446995,VFP257WR8B,0,0,0,899.99,
747115447008,VFP270NR6B,0,0,0,899.99,
747115451333,VFP300NR8B,2,3,5,899.99,
747115447060,VFP300WR8B,1,0,1,899.99,
747115447015,VFP306SR6B,0,0,0,899.99,
747115447022,VFP308NR6B,0,0,0,899.99,
747115447053,VFP653WR8B,0,0,0,899.99,
747115447039,VFP65CMR6B,2,0,2,899.99,
747115447046,VFP65PPR6B,2,0,2,899.99,
747115447077,VFP7MMRR8B,4,0,4,899.99,
747115420292,VGT222RR4O,6,0,6,599.99,
747115420308,VGT223RR4O,6,0,6,599.99,
747115420315,VGT243NR4O,1,0,1,599.99,
747115420322,VGT256RR4O,0,0,0,599.99,
747115431014,VGT257WR6O,0,2,2,599.99,
747115431021,VGT300NR6O,14,9,23,599.99,
747115431038,VGT300WR6O,0,0,0,599.99,
747115420407,VGT308NR4O,19,12,31,599.99,
747115431045,VGT653WR6O,0,0,0,599.99,
747115424009,VGT65CMR4O,29,21,50,599.99,
747115445592,VGT65PPR4O,2,2,4,599.99,
747115420421,VGT7M8RR4O,9,9,18,599.99,
747115431052,VGT7MMRR6O,0,0,0,599.99,
747115451340,VTE243NR6B,1,0,1,1159.99,
747115451357,VTE257WR8B,0,0,0,1159.99,
747115451395,VTE270NR6B,0,0,0,1159.99,
747115451418,VTE300NR8B,0,0,0,1159.99,
747115451425,VTE300WR8B,0,0,0,1159.99,
747115451432,VTE306SR6B,0,0,0,1159.99,
747115451401,VTE308NR6B,0,0,0,1159.99,
747115451371,VTE653WR8B,0,0,0,1159.99,
747115451364,VTE65CMR6B,0,0,0,1159.99,
747115451388,VTE65PPR6B,0,0,0,1159.99,
747115442850,VWB222RR4T,0,0,0,699.99,
747115442898,VWB257WR6T,2,0,2,699.99,
747115442966,VWB300NR6T,1,0,1,699.99,
747115442973,VWB300WR6T,0,0,0,699.99,
747115442904,VWB65CMR4T,0,1,1,699.99,
747115442980,VWB65PPR4T,0,0,0,699.99,
747115437191,VWC243NR0O,1,0,1,799.99,
747115437221,VWC308NR0O,2,0,2,799.99,
747115437207,VWC65CMR0O,0,0,0,799.99,
747115437214,VWC7M8RR0O,2,1,3,799.99,
747115427376,VWR243NR0O,15,6,21,749.99,
747115427383,VWR308NR0O,10,0,10,749.99,
747115431557,VWR65CMR0O,0,0,0,749.99,
747115427390,VWR7M8RR0O,14,8,22,749.99,
747115451449,VYH222RR2B,0,0,0,669.99,
747115451456,VYH223RR2B,0,0,0,669.99,
747115451463,VYH243NR2B,2,0,2,669.99,
747115451494,VYH308NR2B,4,2,6,669.99,
747115451470,VYH65CMR2B,3,0,3,669.99,
747115451487,VYH7M8RR2B,4,1,5,669.99,
747115420902,VYT243NR0O,0,0,0,544.99,
747115420919,VYT308NR0O,12,1,13,544.99,
747115431564,VYT65CMR0O,19,18,37,544.99,
747115420926,VYT7M8RR0O,15,9,24,544.99,
747115448050,VA86300NR8B,14,40,54,899.99,
747115448067,VA86300WR8B,20,35,55,899.99,
747115449682,VA86308NR6B,10,50,60,899.99,
747115448036,VA86653WR8B,6,0,6,899.99,
747115448012,VA8665CMR6B,34,55,89,899.99,
076683897176,849717,1,2,3,18.99,
076683897213,849721,2,1,3,99.99,
076683480125,48012,6,0,6,,
076683480149,48014,2,2,4,,
076683480156,48015,30,2,32,,
076683480163,48016,7,4,11,,
076683480194,48019,0,14,14,,
076683480248,48024,1,0,1,,
076683480255,48025,0,1,1,,
076683480354,48035,12,8,20,,
076683480361,48036,11,4,15,,
076683480408,48040,1,15,16,,
076683480453,48045,1,1,2,,
076683480460,48046,42,2,44,,
076683480477,48047,3,0,3,,
076683480545,48054,7,1,8,,
076683480552,48055,11,8,19,,
076683480613,48061,4,3,7,,
076683480699,48069,10,0,10,,
076683480828,48082,1,2,3,,
076683480903,48090,5,0,5,,
076683480927,48092,0,0,0,,
076683481078,48107,9,9,18,,
076683481085,48108,1,1,2,,
076683482013,48201,7,2,9,,
076683483294,48329,14,0,14,,
076683483300,48330,8,3,11,,
076683483331,48333,1,2,3,,
076683483348,48334,3,10,13,,
076683483355,48335,10,2,12,,
076683483386,48338,6,2,8,,
076683483409,48340,0,0,0,,
076683483478,48347,0,0,0,,
076683483492,48349,2,4,6,,
076683483508,48350,10,5,15,,
076683483515,48351,0,2,2,,
076683483522,48352,3,0,3,,
076683483546,48354,13,0,13,,
076683483553,48355,10,4,14,,
076683483560,48356,2,1,3,,
076683483607,48360,5,5,10,,
076683483645,48364,14,22,36,,
076683483652,48365,11,1,12,,
076683483669,48366,7,2,9,,
076683483751,48375,5,2,7,,
076683483768,48376,4,7,11,,
076683484284,48428,5,14,19,,
076683484352,48435,4,1,5,,
076683484475,48447,8,4,12,,
076683484543,48454,99,99,198,,
076683484598,48459,0,1,1,,
076683484604,48460,0,2,2,,
076683484710,48471,4,2,6,,
076683484932,48493,1,2,3,,
076683485007,48500,0,1,1,,
076683485014,48501,11,8,19,,
076683485021,48502,1,2,3,,
076683485045,48504,13,17,30,,
076683485052,48505,6,8,14,,
076683485137,48513,4,1,5,,
076683490421,49042,7,5,12,,
076683490445,49044,8,2,10,,
076683490452,49045,0,0,0,,
076683490469,49046,14,7,21,,
076683490476,49047-WVR,24,15,39,,
076683490483,49048,8,1,9,,
076683490520,49052,6,2,8,,
076683490537,49053,12,3,15,,
076683490568,49056,4,5,9,,
076683490629,49062-WVR,1,0,1,,
076683490742,49074,10,9,19,,
076683491633,49163,4,4,8,,
076683493026,49302,8,3,11,,
076683493033,49303,43,7,50,,
076683493040,49304,4,6,10,,
076683493057,49305,17,4,21,,
076683493071,49307,0,1,1,,
076683497130,49713,0,0,0,,
076683498199,49819,0,0,0,,
076683996930,99693,0,11,11,,
076683996947,99694,1,2,3,,
076683849007,WEA849900,74,48,122,44.99,
604544625622,00706WM,99,18,117,8.99,3.99
076683480101,48010,99,99,198,2.99,
076683480224,48022,99,99,198,2.99,
076683480231,48023,74,75,149,3.29,
076683480392,48039,56,50,106,2.89,
076683480422,48042,99,99,198,3.99,
076683480590,48059,32,35,67,6.99,
076683480651,48065,29,36,65,9.99,3.99
076683480811,48081,56,36,92,5.89,2.49
076683480835,48083,79,66,145,2.89,
076683480910,48091,39,44,83,2.99,
076683480996,48099,16,32,48,17.99,6.29
076683481061,48106,99,99,198,6.49,1.99
076683482266,48226,5,0,5,12.49,3.99
076683482419,48241,99,87,186,10.19,3.99
076683482471,48247,99,99,198,12.49,3.99
076683482495,48249,51,40,91,10.19,2.99
076683482600,48260,81,60,141,,
076683482617,48261,99,99,198,,
076683482754,48275,65,50,115,10.19,2.99
076683482822,48282,99,99,198,12.49,4.99
604544633696,48305,99,99,198,16.99,4.99
604544633757,48309,99,99,198,16.99,4.99
604544633771,48310,99,99,198,10.99,3.99
604544633795,48311,99,99,198,,
604544633818,48312,99,99,198,10.99,4.49
604544633832,48313,99,99,198,11.99,
604544647747,48343,0,57,57,22.99,8.99
604544647655,48344,99,99,198,22.99,8.99
076683483461,48346,99,99,198,4.49,1.99
076683484208,48420,99,99,198,,
076683484215,48421,99,99,198,,
076683484512,48451,99,99,198,2.49,
604544634013,48477,99,90,189,7.99,2.49
604544647662,48489,99,99,198,7.99,2.99
076683485410,48541,0,37,37,27.99,9.99
076683486325,48632,0,8,8,6.29,
076683486332,48633,99,99,198,4.39,
076683489012,48901,99,99,198,16.49,6.49
076683489036,48903,99,99,198,16.49,6.99
076683489050,48905,99,34,133,14.99,5.99
076683489135,48913,99,99,198,14.99,5.99
076683489142,48914,46,74,120,14.99,5.99
076683489265,48926,7,99,106,15.99,3.99
076683489296,48929,99,99,198,16.49,6.99
076683489302,48930,0,36,36,15.49,5.49
076683489326,48932,25,45,70,15.29,5.49
076683489463,48946,99,99,198,14.49,4.99
076683489487,48948,99,99,198,14.99,5.99
076683489784,48978,6,0,6,16.49,6.99
076683490544,49054,99,99,198,10.99,4.99
076683491558,49155,0,99,99,24.99,10.99
076683497161,49716,6,71,77,11.99,4.99
604544647631,99465,99,99,198,29.99,11.49
076683994783,99478,99,99,198,24.99,10.99
604544630008,99497,23,0,23,38.99,14.99
076683996640,99664,88,69,157,10.99,4.99
076683996657,99665,99,99,198,10.99,3.99
076683473233,47323,99,99,198,11.99,4.99
076683475121,47512,68,80,148,4.99,2.19
046162000151,T00001,52,99,151,30.99,11.99
046162000168,T00002,99,99,198,30.99,11.99
046162000175,T00005,99,99,198,30.99,11.99
046162000182,T00006,99,99,198,30.99,11.99
046162000236,TB00710,99,99,198,12.49,4.99
661120411352,1078195,8,0,8,17.99,
661120412823,1078948,3,0,3,26.99,
661120412724,1081957,2,0,2,47.99,44.99
661120412731,1081958,0,0,0,33.99,29.99
661120412748,1081959,3,5,8,28.99,26.99
661120418047,1099561,18,0,18,36.99,
661120001409,110128,3,1,4,37.99,
661120130888,113088,3,9,12,16.99,
661120107798,1136022,1,0,1,81.99,78.99
661120190509,119050,0,0,0,44.99,
661120561118,156111,1,1,2,94.99,89.99
661120565550,156555,1,2,3,199.99,179.99
661120565598,156559,0,0,0,249.99,229.99
661120569992,156999,0,0,0,23.99,
661120099437,209943,3,0,3,11.49,
661120535560,553556,3,4,7,49.99,46.99
661120621942,562194,0,0,0,66.99,58.99
661120640189,564018,5,6,11,18.99,16.99
661120645078,664507,1,0,1,11.99,10.99
661120109099,710909,0,0,0,66.99,64.99
661120767374,776737,5,0,5,54.99,49.99
661120526360,952636,7,3,10,44.99,
661120546214,954621,1,1,2,29.99,27.99
810025501785,ACP-COM-45A,0,0,0,2499.99,
810025501907,ACP-FS-45A,0,0,0,2499.99,
810025501938,ACP-FS-9A,0,0,0,2599.99,
811826028532,COM-PR-45A,0,0,0,3399.99,
811826028570,CQB-CP-45A,0,0,0,2699.99,
811826028556,CQB-CP-9A,0,0,0,2779.99,
811826028495,CQB-FS-45A,0,0,0,2699.99,
811826028488,CQB-FS-9A,0,2,2,2779.99,
811826028617,CQBE-FS-45A,0,0,0,3249.99,
811826028778,CQBE-FS-45A-SS,0,0,0,3349.99,
811826028754,CQBE-FS-9A-SS,0,0,0,3399.99,
874218004279,CQBLR-CA-ALLBLK,0,0,0,2949.99,
810025505929,CQBTLE-FSR-45A,0,0,0,2699.99,
810025505936,CQBTLE-FSR-9A,0,0,0,2799.99,
810025507268,DE-SFX9-SC4-A,0,0,0,2469.99,
810025507275,DE-SFX9-SCR4-A,0,0,0,2469.99,
810025501730,DT-CQB-FS-45A,5,0,5,2999.99,
810025501709,DT-EDCX-CPR-9A,0,1,1,2819.99,
811826028471,EDCX-CPR-9A,0,0,0,2499.99,
810025500955,EDCX-LPR-9A,0,0,0,2599.99,
810025506551,SFX9-CPR4-A,0,0,0,2379.99,
810025507305,SFX9-FSR5-A,0,0,0,2449.99,
810025505790,SFX9-SC3-A,0,0,0,2299.99,
810025505813,SFX9-SCR3-A,0,0,0,2299.99,
811826028877,TC-COM-45A,0,0,0,3249.99,
811826028891,TC-COM-9A,0,0,0,3329.99,
810025507824,ULC-COM-45A,0,0,0,3149.99,
810025507848,ULC-COM-9A,0,0,0,3239.99,
810025507855,ULC-FS-45A,0,0,0,3149.99,
810025507862,ULC-FS-9A,1,4,5,3224.99,
810025507886,ULCCOM-CP-45A,0,0,0,3149.99,
810025507909,ULCCOM-CP-9A,0,0,0,3239.99,
810025502553,XP-COM-45A,0,0,0,3249.99,
810025507916,XP-COMCP-45A-LW,0,0,0,3349.99,
810025507923,XP-COMCP-9A-LW,0,0,0,3399.99,
810025501716,XP-FS-45A,0,0,0,3249.99,
810025502560,XPD-COPR-9A,0,0,0,2659.99,
810025502577,XPD-CPR-9A,0,0,0,2599.99,
810025501723,XPD-LPR-9A,0,0,0,2699.99,
811826028679,XTCE-FS-45A,0,0,0,3449.99,
874218002350,47,44,5,49,29.99,
811826022738,47-45FS10,24,29,53,34.99,
874218002367,470X,8,3,11,29.99,
874218002374,470XC,10,10,20,34.99,
874218000004,47D,0,0,0,29.99,
874218002589,47DC,38,15,53,34.99,
874218002596,47DCB,8,10,18,36.99,
874218002602,47DE,11,8,19,30.99,
874218003883,47NX,34,17,51,34.99,
874218004361,500,0,18,18,30.99,
874218008659,500-38S,2,23,25,34.99,
811826022752,500-45FS10,23,16,39,36.99,
811826022769,500-45FS10B,0,0,0,40.99,
874218004491,500-9,20,12,32,34.99,
811826021755,500-9C9,10,8,18,34.99,
874218004521,500B,0,10,10,34.99,
811826021045,800,0,0,0,49.99,
811826021601,800-9,10,11,21,,
811826023124,849,1,15,16,37.99,
811826029010,959,0,11,11,39.99,
810025505004,TR-WMAG30B,36,24,60,14.99,
810025505011,TR-WMAG30T,76,0,76,14.99,
810025503727,320-C2SB,2,2,4,54.99,
810025503734,320-C2ST,0,7,7,54.99,
810025503826,320-CCMB,0,0,0,54.99,
810025503833,320-CCMT,1,0,1,54.99,
810025503789,320-CCSB,1,4,5,54.99,
810025503796,320-CCST,3,1,4,54.99,
810025502614,320-CMB,0,0,0,54.99,
810025502621,320-CMT,0,0,0,54.99,
810025502638,320-CSB,1,2,3,,
810025502645,320-CST,2,6,8,54.99,
810025502676,320-FSB,8,10,18,54.99,
810025502683,320-FST,3,5,8,54.99,
810025503819,320-XCST,3,2,5,54.99,
810025507077,365-MB,0,0,0,51.99,
810025507084,365-SB,4,1,5,51.99,
810025507091,365-ST,5,2,7,51.99,
810025507107,365XL-MB,11,3,14,51.99,
810025507114,365XL-SB,18,13,31,51.99,
810025507121,365XL-ST,12,0,12,,
811826027481,TR-LWM-1,6,3,9,129.99,
048702026027,534313140,0,0,0,2749.0,
048702006869,511205291,0,0,0,769.0,
048702006876,511205292,0,0,0,769.0,
048702006883,511205391,0,0,0,669.0,
048702006890,511205392,0,0,0,669.0,
048702009952,511205691,0,0,0,789.0,
048702007392,511210391,0,0,0,789.0,
048702007408,511210392,0,0,0,789.0,
048702010583,511210692,0,0,0,899.0,
048702008627,511211391,0,0,0,789.0,
048702008610,511211392,0,0,0,789.0,
048702008641,511211692,0,0,0,899.0,
048702008955,511212292,0,0,0,879.0,
048702008979,511212392,0,0,0,789.0,
048702017582,511212691,0,0,0,899.0,
048702017599,511212692,0,0,0,899.0,
048702010118,511215340,0,0,0,809.0,
048702016936,511233292,0,0,0,859.0,
048702020322,511233392,0,0,0,769.0,
048702020339,511233691,0,0,0,879.0,
048702020346,511233692,0,0,0,879.0,
048702017001,511236391,0,0,0,929.0,
048702016998,511236392,0,0,0,929.0,
048702018268,511249292,0,0,0,859.0,
048702020384,511249392,0,0,0,769.0,
048702020407,511249692,0,0,0,879.0,
048702018213,511250292,0,0,0,879.0,
048702018237,511250392,0,0,0,789.0,
048702018244,511250691,0,0,0,899.0,
048702018251,511250692,0,0,0,899.0,
048702018718,511252292,0,0,0,869.0,
048702018749,511252392,0,0,0,779.0,
048702019043,511258292,0,0,0,879.0,
048702019067,511258392,0,0,0,789.0,
048702019074,511258691,0,0,0,899.0,
048702019081,511258692,0,0,0,899.0,
048702019241,511263292,0,0,0,859.0,
048702020421,511263392,0,0,0,769.0,
048702020438,511263691,0,0,0,879.0,
048702020445,511263692,0,0,0,879.0,
048702020506,511268292,0,0,0,879.0,
048702020520,511268392,0,0,0,789.0,
048702020537,511268691,0,0,0,899.0,
048702020568,511269292,0,0,0,859.0,
048702020582,511269392,0,0,0,769.0,
048702020599,511269691,0,0,0,879.0,
048702022340,511283292,0,0,0,989.0,
048702022425,511286392,0,0,0,889.0,
048702022579,511288290,0,0,0,879.0,
048702022586,511288291,0,0,0,879.0,
048702022593,511288292,0,0,0,879.0,
048702022609,511288690,0,0,0,899.0,
048702022661,511289292,0,0,0,879.0,
048702022647,511289392,0,0,0,789.0,
048702023088,511289691,0,0,0,899.0,
048702023095,511289692,0,0,0,899.0,
048702022708,511290292,0,0,0,859.0,
048702022685,511290392,0,0,0,769.0,
048702023101,511290691,0,0,0,879.0,
048702023118,511290692,0,0,0,879.0,
048702024030,511303292,0,0,0,879.0,
048702024016,511303392,0,0,0,789.0,
048702024047,511303691,0,0,0,899.0,
048702024054,511303692,0,0,0,899.0,
048702024092,511304292,0,0,0,859.0,
048702024078,511304392,0,0,0,769.0,
048702024108,511304691,0,0,0,879.0,
048702024115,511304692,0,0,0,879.0,
048702024481,511305292,0,0,0,989.0,
048702024528,511306292,0,0,0,989.0,
048702025976,511311292,0,0,0,969.0,
048702025990,511312292,0,0,0,969.0,
048702026010,511313292,0,0,0,969.0,
048702120862,512251291,6,11,17,309.0,
048702120855,512251292,11,13,24,309.0,
048702114083,512251391,9,13,22,289.0,
048702114076,512251392,33,12,45,289.0,
048702004735,512251691,5,1,6,309.0,
048702004742,512251692,10,6,16,309.0,
048702114090,512252395,57,19,76,269.0,
048702004971,512252695,11,12,23,289.0,
048702120336,512257392,0,1,1,369.0,
048702001635,512261340,2,0,2,399.0,
048702006807,512261640,6,0,6,419.0,
048702002120,512266391,3,2,5,309.0,
048702002137,512266392,15,13,28,309.0,
048702004681,512266691,10,10,20,329.0,
048702004698,512266692,7,14,21,329.0,
048702003196,512268395,22,12,34,309.0,
048702006609,512268695,27,25,52,329.0,
048702003493,512271391,0,4,4,309.0,
048702003509,512271392,13,3,16,309.0,
048702004704,512271690,4,5,9,329.0,
048702004711,512271691,6,6,12,329.0,
048702003912,512287390,7,0,7,309.0,
048702004131,512293292,9,0,9,369.0,
048702004117,512293392,17,5,22,349.0,
048702006982,512293691,3,2,5,369.0,
048702006999,512293692,6,2,8,369.0,
048702004339,512296393,13,0,13,369.0,
048702004346,512296394,3,0,3,369.0,
048702004353,512297392,8,7,15,369.0,
048702004360,512297393,23,7,30,369.0,
048702007316,512326395,12,15,27,289.0,
048702007323,512326695,0,0,0,309.0,
048702007330,512327395,8,8,16,339.0,
048702007354,512328395,7,3,10,369.0,
048702007361,512328695,10,8,18,389.0,
048702007880,512337339,5,7,12,269.0,
048702008443,512341290,29,0,29,339.0,
048702008450,512341690,11,0,11,339.0,
048702010248,512352290,15,1,16,439.0,
048702010545,512352390,0,0,0,409.0,
048702010255,512352690,0,0,0,439.0,
048702010552,512357290,34,1,35,399.0,
048702010569,512357690,12,2,14,399.0,
048702016769,512364292,7,0,7,339.0,
048702020148,512364392,6,0,6,319.0,
048702020155,512364691,9,1,10,339.0,
048702020162,512364692,10,10,20,339.0,
048702017117,512367690,10,1,11,329.0,
048702018299,512394292,16,0,16,369.0,
048702018312,512394392,3,8,11,349.0,
048702018329,512394691,11,7,18,369.0,
048702018336,512394692,5,2,7,369.0,
048702018343,512395292,21,13,34,339.0,
048702020209,512395392,0,3,3,319.0,
048702020216,512395691,4,2,6,339.0,
048702020223,512395692,8,0,8,339.0,
048702019265,512401292,12,4,16,339.0,
048702020247,512401392,5,1,6,319.0,
048702020254,512401691,13,3,16,339.0,
048702020261,512401692,13,5,18,339.0,
048702019296,512402292,13,2,15,369.0,
048702019319,512402392,9,1,10,349.0,
048702019326,512402691,5,7,12,369.0,
048702019333,512402692,8,4,12,369.0,
048702019661,512404392,8,6,14,379.0,
048702019678,512404691,0,0,0,399.0,
048702019685,512404692,0,2,2,399.0,
048702020070,512410395,0,9,9,409.0,
048702020629,512413292,13,17,30,369.0,
048702020643,512413392,11,5,16,349.0,
048702020650,512413691,21,1,22,369.0,
048702020681,512414292,20,10,30,339.0,
048702020704,512414392,3,5,8,319.0,
048702020711,512414691,9,6,15,339.0,
048702022463,512425395,11,11,22,289.99,
048702022470,512425695,4,3,7,309.99,
048702022487,512426290,7,2,9,379.0,
048702022500,512426292,0,1,1,379.0,
048702022517,512426390,9,6,15,359.0,
048702022524,512426391,11,4,15,359.0,
048702022531,512426392,13,11,24,359.0,
048702022548,512426690,1,3,4,379.0,
048702022555,512426691,4,5,9,379.0,
048702024177,512431292,25,15,40,369.0,
048702024191,512431392,25,15,40,349.0,
048702024207,512431691,4,0,4,369.0,
048702024214,512431692,4,0,4,369.0,
048702024351,512432292,13,4,17,339.0,
048702024375,512432392,10,5,15,319.0,
048702024382,512432691,2,0,2,339.0,
048702024399,512432692,3,0,3,339.0,
048702024238,512433292,12,5,17,369.0,
048702024252,512433392,13,3,16,349.0,
048702024269,512433691,3,0,3,369.0,
048702024276,512433692,2,0,2,369.0,
048702024290,512434292,0,6,6,339.0,
048702024313,512434392,3,3,6,319.0,
048702024320,512434691,2,0,2,339.0,
048702024337,512434692,1,0,1,339.0,
048702024405,512435395,39,13,52,319.0,
048702024412,512435695,5,4,9,339.0,
048702025044,512440392,7,4,11,319.0,
048702025785,512440692,5,5,10,339.0,
048702025402,512446292,10,4,14,369.0,
048702025440,512446692,5,5,10,369.0,
048702025631,512450395,10,9,19,319.0,
048702025648,512450695,7,4,11,339.0,
048702025662,512451392,0,0,0,409.0,
048702025686,512451692,0,0,0,429.0,
048702026034,512454290,0,0,0,439.0,
048702026041,512454690,0,0,0,439.0,
048702009181,513076391,0,0,0,1609.99,
048702017872,521100102,99,99,198,199.0,
048702017889,521101102,53,22,75,219.0,
048702020742,521104102,88,99,187,239.0,224.99
048702023187,521110102,81,54,135,229.0,
048702023194,521111102,99,99,198,249.0,
048702024450,521139102,17,0,17,199.0,
048702024467,521140102,10,10,20,219.0,
048702024832,521141102,16,7,23,249.0,
048702026119,521154102,0,0,0,249.0,
048702003554,524100102,0,0,0,1169.0,
048702003585,524100186,0,0,0,1169.0,
048702018435,525200102,0,0,0,239.0,
048702026058,525201102,0,0,0,259.0,
048702026065,525206102,0,0,0,269.0,
048702026072,525207102,0,0,0,289.0,
048702026096,525209102,0,0,0,299.0,
048702148958,534070128,0,0,0,1099.0,
048702149009,534070154,0,0,0,1159.0,
048702117718,534162124,0,0,0,879.0,
048702117725,534162137,0,0,0,879.0,
048702003844,534162141,0,0,0,879.0,
048702119583,534174114,0,0,0,999.0,
048702004766,534174160,0,0,0,1009.0,
048702119590,534175142,0,0,0,1089.0,
048702006852,534175171,0,0,0,1089.0,
048702119613,534177124,0,0,0,879.0,
048702119637,534177137,0,0,0,879.0,
048702119644,534177140,0,0,0,879.0,
048702119620,534177141,0,0,0,879.0,
048702119668,534178114,0,0,0,1139.0,
048702119675,534178117,0,0,0,1139.0,
048702121715,534191114,0,0,0,1199.0,
048702121722,534191160,0,0,0,1189.0,
048702003202,534199114,0,0,0,979.0,
048702003219,534199117,0,0,0,979.0,
048702003226,534200137,0,0,0,1059.0,
048702003820,534200140,0,0,0,1059.0,
048702003837,534200141,0,0,0,1059.0,
048702003592,534202137,0,0,0,1299.0,
048702003868,534202140,0,0,0,1299.0,
048702003875,534202141,0,0,0,1299.0,
048702004254,534217137,0,0,0,1419.0,
048702004261,534217140,0,0,0,1419.0,
048702006845,534217141,0,0,0,1419.0,
048702006043,534227142,0,0,0,1449.0,
048702006111,534228137,0,0,0,1399.0,
048702006128,534228140,0,0,0,1399.0,
048702006135,534228141,0,0,0,1399.0,
048702010385,534255137,0,0,0,1069.0,
048702010408,534255140,0,0,0,1069.0,
048702010392,534255141,0,0,0,1069.0,
048702015854,534259137,0,0,0,1639.0,
048702015861,534259140,0,0,0,1639.0,
048702015878,534259141,0,0,0,1639.0,
048702019708,534280137,0,0,0,1399.0,
048702019722,534280141,0,0,0,1399.0,
048702019746,534281142,0,0,0,1219.0,
048702019777,534283124,0,0,0,1769.0,
048702019784,534283137,0,0,0,1769.0,
048702019760,534283141,0,0,0,1769.0,
048702019982,534286128,0,0,0,1319.0,
048702019975,534286154,0,0,0,1369.0,
048702021725,534291114,0,0,0,1669.0,
048702021732,534291117,0,0,0,1669.0,
048702002144,535200210,0,0,0,959.0,
048702002151,535200212,0,0,0,959.0,
048702002175,535200220,0,0,0,959.0,
048702002199,535200225,0,0,0,959.0,
048702002205,535200226,0,0,0,959.0,
048702005497,535200227,0,0,0,959.0,
048702002212,535200228,0,0,0,959.0,
048702002267,535200229,0,0,0,979.0,
048702002274,535200233,0,0,0,979.0,
048702002243,535200255,0,0,0,979.0,
048702016172,535200289,0,0,0,979.0,
048702019142,535200294,0,0,0,979.0,
048702022272,535200299,0,0,0,979.0,
048702002281,535201210,0,0,0,959.0,
048702002298,535201212,0,0,0,959.0,
048702002311,535201220,0,0,0,959.0,
048702016189,535201289,0,0,0,979.0,
048702019159,535201294,0,0,0,979.0,
048702004209,535203220,0,0,0,1259.0,
048702002427,535203226,0,0,0,1259.0,
048702002434,535203228,0,0,0,1259.0,
048702017148,535203229,0,0,0,1289.0,
048702002465,535203230,0,0,0,1289.0,
048702002472,535203233,0,0,0,1289.0,
048702002489,535203236,0,0,0,1289.0,
048702016196,535203289,0,0,0,1219.0,
048702022265,535203299,0,0,0,1289.0,
048702002519,535204139,0,0,0,1319.0,
048702002502,535204144,0,0,0,1319.0,
048702002496,535204161,0,0,0,1319.0,
048702002526,535205128,0,0,0,1179.0,
048702002533,535205133,0,0,0,1179.0,
048702002540,535205136,0,0,0,1179.0,
048702002557,535205138,0,0,0,1219.0,
048702002571,535206218,0,0,0,1359.0,
048702002588,535206220,0,0,0,1359.0,
048702002595,535206225,0,0,0,1359.0,
048702002618,535206228,0,0,0,1359.0,
048702002656,535206230,0,0,0,1359.0,
048702016202,535206289,0,0,0,1359.0,
048702007002,535218212,0,0,0,1399.0,
048702007019,535218220,0,0,0,1399.0,
048702006012,535218226,0,0,0,1399.0,
048702006029,535218228,0,0,0,1399.0,
048702008931,535218229,0,0,0,1429.0,
048702007378,535218230,0,0,0,1429.0,
048702006036,535218233,0,0,0,1429.0,
048702018534,535218289,0,0,0,1429.0,
048702022319,535218294,0,0,0,1429.0,
048702022326,535218299,0,0,0,1429.0,
048702016219,535232289,0,0,0,1359.0,
048702016417,535234212,0,0,0,1099.0,
048702016509,535234233,0,0,0,1099.0,
048702016455,535234255,0,0,0,1099.0,
048702016448,535234264,0,0,0,1099.0,
048702016424,535234289,0,0,0,1099.0,
048702016516,535235212,0,0,0,1429.0,
048702016615,535235236,0,0,0,1429.0,
048702018831,535238220,0,0,0,1319.0,
048702018886,535238226,0,0,0,1319.0,
048702018893,535238228,0,0,0,1319.0,
048702018909,535238229,0,0,0,1349.0,
048702018916,535238230,0,0,0,1349.0,
048702018923,535238233,0,0,0,1349.0,
048702018855,535238255,0,0,0,1349.0,
048702018817,535238289,0,0,0,1349.0,
048702022234,535238299,0,0,0,1349.0,
048702018541,535239212,0,0,0,1659.0,
048702018565,535239220,0,0,0,1659.0,
048702018572,535239226,0,0,0,1659.0,
048702018589,535239228,0,0,0,1659.0,
048702018596,535239229,0,0,0,1689.0,
048702018602,535239230,0,0,0,1689.0,
048702018619,535239233,0,0,0,1689.0,
048702018558,535239289,0,0,0,1689.0,
048702022296,535239294,0,0,0,1689.0,
048702022302,535239299,0,0,0,1689.0,
048702021343,535242220,0,0,0,1379.0,
048702021404,535242228,0,0,0,1399.0,
048702021411,535242229,0,0,0,1399.0,
048702021428,535242230,0,0,0,1399.0,
048702021435,535242233,0,0,0,1399.0,
048702021374,535242255,0,0,0,1399.0,
048702021329,535242289,0,0,0,1399.0,
048702021350,535242294,0,0,0,1399.0,
048702022081,535242299,0,0,0,1399.0,
048702021459,535243210,0,0,0,1319.0,
048702021480,535243220,0,0,0,1319.0,
048702021503,535243255,0,0,0,1339.0,
048702021473,535243289,0,0,0,1339.0,
048702021510,535243294,0,0,0,1339.0,
048702021527,535243299,0,0,0,1339.0,
048702023392,535244212,0,0,0,1369.0,
048702023415,535244218,0,0,0,1369.0,
048702023422,535244220,0,0,0,1369.0,
048702023484,535244226,0,0,0,1369.0,
048702023491,535244228,0,0,0,1369.0,
048702023507,535244229,0,0,0,1399.0,
048702023514,535244230,0,0,0,1399.0,
048702023521,535244233,0,0,0,1399.0,
048702023460,535244255,0,0,0,1399.0,
048702023408,535244289,0,0,0,1399.0,
048702023439,535244294,0,0,0,1399.0,
048702023446,535244299,0,0,0,1399.0,
048702010057,535700208,0,0,0,459.0,
048702004568,535700212,0,0,0,459.0,
048702004575,535700218,0,0,0,459.0,
048702004582,535700220,0,0,0,459.0,
048702004629,535700226,0,0,0,459.0,
048702004636,535700228,0,0,0,459.0,
048702006418,535700230,0,0,0,459.0,
048702004643,535700233,0,0,0,459.0,
048702004650,535700236,0,0,0,459.0,
048702004605,535700255,0,0,0,459.0,
048702004599,535700264,0,0,0,459.0,
048702008832,535700289,0,0,0,459.0,
048702017933,535700294,0,0,0,459.0,
048702018411,535700296,0,0,0,459.0,
048702021176,535700299,0,0,0,459.0,
048702006678,535705212,0,0,0,639.0,
048702006685,535705218,0,0,0,639.0,
048702006692,535705220,0,0,0,639.0,
048702005923,535705226,0,0,0,639.0,
048702005930,535705228,0,0,0,639.0,
048702005947,535705230,0,0,0,639.0,
048702005954,535705233,0,0,0,639.0,
048702005961,535705236,0,0,0,639.0,
048702006715,535705255,0,0,0,639.0,
048702008801,535705289,0,0,0,639.0,
048702020940,535705294,0,0,0,639.0,
048702018473,535705296,0,0,0,639.0,
048702023231,535705299,4,0,4,639.0,
048702021589,535709208,0,0,0,529.0,
048702006289,535709212,0,0,0,529.0,
048702006296,535709218,0,0,0,529.0,
048702006302,535709220,0,0,0,529.0,
048702006340,535709226,0,0,0,529.0,
048702006357,535709228,0,0,0,529.0,
048702006364,535709230,0,0,0,529.0,
048702006371,535709233,0,0,0,529.0,
048702006326,535709255,0,0,0,529.0,
048702008825,535709289,0,0,0,529.0,
048702017957,535709294,0,0,0,529.0,
048702023071,535709299,0,0,0,529.0,
048702021145,535711208,0,0,0,549.0,
048702007125,535711233,0,0,0,549.0,
048702008764,535711289,0,0,0,549.0,
048702008757,535711290,0,0,0,549.0,
048702018008,535711294,0,0,0,549.0,
048702018497,535711296,0,0,0,549.0,
048702023217,535711299,0,0,0,549.0,
048702008030,535720212,0,0,0,459.0,
048702008047,535720218,0,0,0,459.0,
048702008054,535720220,0,0,0,459.0,
048702009655,535720289,0,0,0,459.0,
048702017964,535720294,0,0,0,459.0,
048702018428,535720296,0,0,0,459.0,
048702023064,535720299,0,0,0,459.0,
048702021138,535727208,0,0,0,689.0,
048702009501,535727212,0,0,0,689.0,
048702009556,535727228,0,0,0,689.0,
048702009518,535727289,0,0,0,689.0,
048702018503,535727296,0,0,0,689.0,
048702023200,535727299,0,0,0,689.0,
048702010347,535732289,0,0,0,929.0,
048702010330,535732290,0,0,0,929.0,
048702020988,535732294,0,0,0,929.0,
048702022104,535732299,0,0,0,929.0,
048702015960,535737212,0,0,0,639.0,
048702015984,535737218,0,0,0,639.0,
048702015991,535737220,0,0,0,639.0,
048702015977,535737289,0,0,0,639.0,
048702018480,535737296,0,0,0,639.0,
048702016271,535740212,0,0,0,689.0,
048702016295,535740218,0,0,0,689.0,
048702016301,535740220,0,0,0,689.0,
048702017230,535740226,1,1,2,689.0,
048702017247,535740228,0,0,0,689.0,
048702017254,535740230,0,0,0,689.0,
048702017261,535740233,0,0,0,689.0,
048702017278,535740236,0,0,0,689.0,
048702016325,535740255,0,0,0,689.0,
048702016318,535740264,0,0,0,689.0,
048702016288,535740289,0,0,0,689.0,
048702018466,535740296,0,0,0,689.0,
048702022111,535740299,0,0,0,689.0,
048702016349,535741212,0,0,0,529.0,
048702016363,535741218,0,0,0,529.0,
048702016370,535741220,0,0,0,529.0,
048702017186,535741226,0,0,0,529.0,
048702017193,535741228,0,0,0,529.0,
048702017209,535741230,0,0,0,529.0,
048702017216,535741233,0,0,0,529.0,
048702017223,535741236,0,0,0,529.0,
048702016394,535741255,0,0,0,529.0,
048702016387,535741264,0,0,0,529.0,
048702016356,535741289,0,0,0,529.0,
048702017988,535741294,0,0,0,529.0,
048702018381,535741296,0,0,0,529.0,
048702022128,535741299,0,0,0,529.0,
048702019395,535757289,0,0,0,549.0,
048702019425,535757290,0,0,0,549.0,
048702020919,535757294,0,0,0,549.0,
048702019401,535757296,0,0,0,549.0,
048702022135,535757299,0,0,0,549.0,
048702022753,535771220,0,0,0,529.0,
048702022777,535771226,0,0,0,529.0,
048702022784,535771228,0,0,0,529.0,
048702022838,535771230,0,0,0,529.0,
048702022845,535771233,0,0,0,529.0,
048702022852,535771236,0,0,0,529.0,
048702022821,535771255,0,0,0,529.0,
048702022739,535771289,0,0,0,529.0,
048702022791,535771294,0,0,0,529.0,
048702022760,535771296,0,0,0,529.0,
048702022807,535771299,0,0,0,529.0,
048702022920,535773208,0,0,0,589.0,
048702022937,535773212,0,0,0,589.0,
048702022951,535773218,0,0,0,589.0,
048702022968,535773220,0,0,0,589.0,
048702023026,535773226,0,0,0,589.0,
048702023033,535773228,0,0,0,589.0,
048702023040,535773230,0,0,0,589.0,
048702023057,535773233,0,0,0,589.0,
048702023019,535773255,0,0,0,589.0,
048702022944,535773289,0,0,0,589.0,
048702022982,535773294,0,0,0,589.0,
048702022975,535773296,0,0,0,589.0,
048702022999,535773299,0,0,0,589.0,
048702023293,535776220,0,0,0,609.0,
048702023378,535776230,0,0,0,609.0,
048702023385,535776233,0,0,0,609.0,
048702023347,535776255,0,0,0,609.0,
048702023279,535776289,0,0,0,609.0,
048702023316,535776294,0,0,0,609.0,
048702023309,535776296,0,0,0,609.0,
048702023323,535776299,0,0,0,609.0,
023614944089,112028022,0,0,0,9.99,
048702010736,112098800,5,10,15,17.99,
048702010743,112098801,0,13,13,17.99,
048702010750,112098802,5,4,9,17.99,
048702010767,112098803,2,10,12,17.99,
048702019647,112098804,51,0,51,17.99,
048702179143,513046371,0,0,0,1529.99,
048702171543,513054493,0,0,0,1909.99,
048702171581,513054494,0,0,0,1909.99,
048702114106,513059493,0,0,0,2149.99,
048702021756,534293206,0,0,0,1339.0,
048702021763,534293207,0,0,0,1339.0,
048702021770,534293208,0,0,0,1339.0,
048702021800,534293289,0,0,0,1339.0,
048702022180,512418395,99,6,105,339.99,
048702025334,512443392,99,99,198,349.99,
048702023651,521121102,99,61,160,259.99,
048702023668,521122102,24,0,24,259.99,
048702023675,521123102,99,0,99,309.99,
048702022005,534297137,0,0,0,1569.99,
048702022029,534298137,0,0,0,1079.99,
048702023699,534306142,0,0,0,1629.99,
048702023705,534307128,0,0,0,1699.99,
048702023712,534308128,0,0,0,2849.99,
048702023972,534311137,0,0,0,1479.99,
848037000019,R16A4T,1,2,3,799.99,
848037055088,R16FTT-9MM,1,0,1,979.99,
848037000033,R16M4A4T,1,0,1,799.99,
848037028464,R16M4FTT-762,0,0,0,739.99,
848037016034,R16M4FTT-C3,7,4,11,809.99,
848037017765,R16M4FTT-C4,4,4,8,809.99,
848037004383,R16M4LHRFT,0,0,0,759.99,
848037026057,R16SFST-308,4,0,4,1289.99,
848037055477,R16SLFTT,10,12,22,729.99,
848037054135,R16SLSFSM-CA,0,8,8,984.99,
848037029355,R18FFTWS-1-308,0,0,0,1239.99,
848037028945,R18FFTWS-2-308,3,0,3,1289.99,
848037030412,R18FSFSM-308,6,0,6,1349.99,
848037056276,R20GVTA1S-7,0,0,0,914.99,
848037022592,R20GVTA4S-7,0,2,2,899.99,
848037058225,R16M4SFSM-7,0,0,0,879.99,
848037034090,R18FFT-308,5,1,6,1149.99,
814660020007,SG02030008,14,4,18,,
814660021813,SG05080106-01,14,0,14,,
814660020779,SG06030008,11,4,15,,
850034726304,ZF501MGSF9BK,0,4,4,1499.99,
850034726281,ZF501MGSF9DE,8,31,39,1639.99,
850034726410,ZF5P01MAGBK,1,10,11,1579.99,
